# NAME = EMOJI:GROUP:SUBGROUP
grinning face = ğŸ˜€:smileys_emotion:face_smiling
grinning face with big eyes = ğŸ˜ƒ:smileys_emotion:face_smiling
grinning face with smiling eyes = ğŸ˜„:smileys_emotion:face_smiling
beaming face with smiling eyes = ğŸ˜:smileys_emotion:face_smiling
grinning squinting face = ğŸ˜†:smileys_emotion:face_smiling
grinning face with sweat = ğŸ˜…:smileys_emotion:face_smiling
rolling on the floor laughing = ğŸ¤£:smileys_emotion:face_smiling
face with tears of joy = ğŸ˜‚:smileys_emotion:face_smiling
slightly smiling face = ğŸ™‚:smileys_emotion:face_smiling
upside-down face = ğŸ™ƒ:smileys_emotion:face_smiling
melting face = ğŸ« :smileys_emotion:face_smiling
winking face = ğŸ˜‰:smileys_emotion:face_smiling
smiling face with smiling eyes = ğŸ˜Š:smileys_emotion:face_smiling
smiling face with halo = ğŸ˜‡:smileys_emotion:face_smiling
smiling face with hearts = ğŸ¥°:smileys_emotion:face_affection
smiling face with heart-eyes = ğŸ˜:smileys_emotion:face_affection
star-struck = ğŸ¤©:smileys_emotion:face_affection
face blowing a kiss = ğŸ˜˜:smileys_emotion:face_affection
kissing face = ğŸ˜—:smileys_emotion:face_affection
smiling face = â˜º:smileys_emotion:face_affection
kissing face with closed eyes = ğŸ˜š:smileys_emotion:face_affection
kissing face with smiling eyes = ğŸ˜™:smileys_emotion:face_affection
smiling face with tear = ğŸ¥²:smileys_emotion:face_affection
face savoring food = ğŸ˜‹:smileys_emotion:face_tongue
face with tongue = ğŸ˜›:smileys_emotion:face_tongue
winking face with tongue = ğŸ˜œ:smileys_emotion:face_tongue
zany face = ğŸ¤ª:smileys_emotion:face_tongue
squinting face with tongue = ğŸ˜:smileys_emotion:face_tongue
money-mouth face = ğŸ¤‘:smileys_emotion:face_tongue
smiling face with open hands = ğŸ¤—:smileys_emotion:face_hand
face with hand over mouth = ğŸ¤­:smileys_emotion:face_hand
face with open eyes and hand over mouth = ğŸ«¢:smileys_emotion:face_hand
face with peeking eye = ğŸ«£:smileys_emotion:face_hand
shushing face = ğŸ¤«:smileys_emotion:face_hand
thinking face = ğŸ¤”:smileys_emotion:face_hand
saluting face = ğŸ«¡:smileys_emotion:face_hand
zipper-mouth face = ğŸ¤:smileys_emotion:face_neutral_skeptical
face with raised eyebrow = ğŸ¤¨:smileys_emotion:face_neutral_skeptical
neutral face = ğŸ˜:smileys_emotion:face_neutral_skeptical
expressionless face = ğŸ˜‘:smileys_emotion:face_neutral_skeptical
face without mouth = ğŸ˜¶:smileys_emotion:face_neutral_skeptical
dotted line face = ğŸ«¥:smileys_emotion:face_neutral_skeptical
face in clouds = ğŸ˜¶â€ğŸŒ«:smileys_emotion:face_neutral_skeptical
smirking face = ğŸ˜:smileys_emotion:face_neutral_skeptical
unamused face = ğŸ˜’:smileys_emotion:face_neutral_skeptical
face with rolling eyes = ğŸ™„:smileys_emotion:face_neutral_skeptical
grimacing face = ğŸ˜¬:smileys_emotion:face_neutral_skeptical
face exhaling = ğŸ˜®â€ğŸ’¨:smileys_emotion:face_neutral_skeptical
lying face = ğŸ¤¥:smileys_emotion:face_neutral_skeptical
relieved face = ğŸ˜Œ:smileys_emotion:face_sleepy
pensive face = ğŸ˜”:smileys_emotion:face_sleepy
sleepy face = ğŸ˜ª:smileys_emotion:face_sleepy
drooling face = ğŸ¤¤:smileys_emotion:face_sleepy
sleeping face = ğŸ˜´:smileys_emotion:face_sleepy
face with medical mask = ğŸ˜·:smileys_emotion:face_unwell
face with thermometer = ğŸ¤’:smileys_emotion:face_unwell
face with head-bandage = ğŸ¤•:smileys_emotion:face_unwell
nauseated face = ğŸ¤¢:smileys_emotion:face_unwell
face vomiting = ğŸ¤®:smileys_emotion:face_unwell
sneezing face = ğŸ¤§:smileys_emotion:face_unwell
hot face = ğŸ¥µ:smileys_emotion:face_unwell
cold face = ğŸ¥¶:smileys_emotion:face_unwell
woozy face = ğŸ¥´:smileys_emotion:face_unwell
face with crossed-out eyes = ğŸ˜µ:smileys_emotion:face_unwell
face with spiral eyes = ğŸ˜µâ€ğŸ’«:smileys_emotion:face_unwell
exploding head = ğŸ¤¯:smileys_emotion:face_unwell
cowboy hat face = ğŸ¤ :smileys_emotion:face_hat
partying face = ğŸ¥³:smileys_emotion:face_hat
disguised face = ğŸ¥¸:smileys_emotion:face_hat
smiling face with sunglasses = ğŸ˜:smileys_emotion:face_glasses
nerd face = ğŸ¤“:smileys_emotion:face_glasses
face with monocle = ğŸ§:smileys_emotion:face_glasses
confused face = ğŸ˜•:smileys_emotion:face_concerned
face with diagonal mouth = ğŸ«¤:smileys_emotion:face_concerned
worried face = ğŸ˜Ÿ:smileys_emotion:face_concerned
slightly frowning face = ğŸ™:smileys_emotion:face_concerned
frowning face = â˜¹:smileys_emotion:face_concerned
face with open mouth = ğŸ˜®:smileys_emotion:face_concerned
hushed face = ğŸ˜¯:smileys_emotion:face_concerned
astonished face = ğŸ˜²:smileys_emotion:face_concerned
flushed face = ğŸ˜³:smileys_emotion:face_concerned
pleading face = ğŸ¥º:smileys_emotion:face_concerned
face holding back tears = ğŸ¥¹:smileys_emotion:face_concerned
frowning face with open mouth = ğŸ˜¦:smileys_emotion:face_concerned
anguished face = ğŸ˜§:smileys_emotion:face_concerned
fearful face = ğŸ˜¨:smileys_emotion:face_concerned
anxious face with sweat = ğŸ˜°:smileys_emotion:face_concerned
sad but relieved face = ğŸ˜¥:smileys_emotion:face_concerned
crying face = ğŸ˜¢:smileys_emotion:face_concerned
loudly crying face = ğŸ˜­:smileys_emotion:face_concerned
face screaming in fear = ğŸ˜±:smileys_emotion:face_concerned
confounded face = ğŸ˜–:smileys_emotion:face_concerned
persevering face = ğŸ˜£:smileys_emotion:face_concerned
disappointed face = ğŸ˜:smileys_emotion:face_concerned
downcast face with sweat = ğŸ˜“:smileys_emotion:face_concerned
weary face = ğŸ˜©:smileys_emotion:face_concerned
tired face = ğŸ˜«:smileys_emotion:face_concerned
yawning face = ğŸ¥±:smileys_emotion:face_concerned
face with steam from nose = ğŸ˜¤:smileys_emotion:face_negative
enraged face = ğŸ˜¡:smileys_emotion:face_negative
angry face = ğŸ˜ :smileys_emotion:face_negative
face with symbols on mouth = ğŸ¤¬:smileys_emotion:face_negative
smiling face with horns = ğŸ˜ˆ:smileys_emotion:face_negative
angry face with horns = ğŸ‘¿:smileys_emotion:face_negative
skull = ğŸ’€:smileys_emotion:face_negative
skull and crossbones = â˜ :smileys_emotion:face_negative
pile of poo = ğŸ’©:smileys_emotion:face_costume
clown face = ğŸ¤¡:smileys_emotion:face_costume
ogre = ğŸ‘¹:smileys_emotion:face_costume
goblin = ğŸ‘º:smileys_emotion:face_costume
ghost = ğŸ‘»:smileys_emotion:face_costume
alien = ğŸ‘½:smileys_emotion:face_costume
alien monster = ğŸ‘¾:smileys_emotion:face_costume
robot = ğŸ¤–:smileys_emotion:face_costume
grinning cat = ğŸ˜º:smileys_emotion:cat_face
grinning cat with smiling eyes = ğŸ˜¸:smileys_emotion:cat_face
cat with tears of joy = ğŸ˜¹:smileys_emotion:cat_face
smiling cat with heart-eyes = ğŸ˜»:smileys_emotion:cat_face
cat with wry smile = ğŸ˜¼:smileys_emotion:cat_face
kissing cat = ğŸ˜½:smileys_emotion:cat_face
weary cat = ğŸ™€:smileys_emotion:cat_face
crying cat = ğŸ˜¿:smileys_emotion:cat_face
pouting cat = ğŸ˜¾:smileys_emotion:cat_face
see-no-evil monkey = ğŸ™ˆ:smileys_emotion:monkey_face
hear-no-evil monkey = ğŸ™‰:smileys_emotion:monkey_face
speak-no-evil monkey = ğŸ™Š:smileys_emotion:monkey_face
kiss mark = ğŸ’‹:smileys_emotion:emotion
love letter = ğŸ’Œ:smileys_emotion:emotion
heart with arrow = ğŸ’˜:smileys_emotion:emotion
heart with ribbon = ğŸ’:smileys_emotion:emotion
sparkling heart = ğŸ’–:smileys_emotion:emotion
growing heart = ğŸ’—:smileys_emotion:emotion
beating heart = ğŸ’“:smileys_emotion:emotion
revolving hearts = ğŸ’:smileys_emotion:emotion
two hearts = ğŸ’•:smileys_emotion:emotion
heart decoration = ğŸ’Ÿ:smileys_emotion:emotion
heart exclamation = â£:smileys_emotion:emotion
broken heart = ğŸ’”:smileys_emotion:emotion
heart on fire = â¤â€ğŸ”¥:smileys_emotion:emotion
mending heart = â¤â€ğŸ©¹:smileys_emotion:emotion
red heart = â¤:smileys_emotion:emotion
orange heart = ğŸ§¡:smileys_emotion:emotion
yellow heart = ğŸ’›:smileys_emotion:emotion
green heart = ğŸ’š:smileys_emotion:emotion
blue heart = ğŸ’™:smileys_emotion:emotion
purple heart = ğŸ’œ:smileys_emotion:emotion
brown heart = ğŸ¤:smileys_emotion:emotion
black heart = ğŸ–¤:smileys_emotion:emotion
white heart = ğŸ¤:smileys_emotion:emotion
hundred points = ğŸ’¯:smileys_emotion:emotion
anger symbol = ğŸ’¢:smileys_emotion:emotion
collision = ğŸ’¥:smileys_emotion:emotion
dizzy = ğŸ’«:smileys_emotion:emotion
sweat droplets = ğŸ’¦:smileys_emotion:emotion
dashing away = ğŸ’¨:smileys_emotion:emotion
hole = ğŸ•³:smileys_emotion:emotion
bomb = ğŸ’£:smileys_emotion:emotion
speech balloon = ğŸ’¬:smileys_emotion:emotion
eye in speech bubble = ğŸ‘â€ğŸ—¨:smileys_emotion:emotion
left speech bubble = ğŸ—¨:smileys_emotion:emotion
right anger bubble = ğŸ—¯:smileys_emotion:emotion
thought balloon = ğŸ’­:smileys_emotion:emotion
ZZZ = ğŸ’¤:smileys_emotion:emotion
waving hand = ğŸ‘‹:people_body:hand_fingers_open
raised back of hand = ğŸ¤š:people_body:hand_fingers_open
hand with fingers splayed = ğŸ–:people_body:hand_fingers_open
raised hand = âœ‹:people_body:hand_fingers_open
vulcan salute = ğŸ––:people_body:hand_fingers_open
rightwards hand = ğŸ«±:people_body:hand_fingers_open
leftwards hand = ğŸ«²:people_body:hand_fingers_open
palm down hand = ğŸ«³:people_body:hand_fingers_open
palm up hand = ğŸ«´:people_body:hand_fingers_open
OK hand = ğŸ‘Œ:people_body:hand_fingers_partial
pinched fingers = ğŸ¤Œ:people_body:hand_fingers_partial
pinching hand = ğŸ¤:people_body:hand_fingers_partial
victory hand = âœŒ:people_body:hand_fingers_partial
crossed fingers = ğŸ¤:people_body:hand_fingers_partial
hand with index finger and thumb crossed = ğŸ«°:people_body:hand_fingers_partial
love-you gesture = ğŸ¤Ÿ:people_body:hand_fingers_partial
sign of the horns = ğŸ¤˜:people_body:hand_fingers_partial
call me hand = ğŸ¤™:people_body:hand_fingers_partial
backhand index pointing left = ğŸ‘ˆ:people_body:hand_single_finger
backhand index pointing right = ğŸ‘‰:people_body:hand_single_finger
backhand index pointing up = ğŸ‘†:people_body:hand_single_finger
middle finger = ğŸ–•:people_body:hand_single_finger
backhand index pointing down = ğŸ‘‡:people_body:hand_single_finger
index pointing up = â˜:people_body:hand_single_finger
index pointing at the viewer = ğŸ«µ:people_body:hand_single_finger
thumbs up = ğŸ‘:people_body:hand_fingers_closed
thumbs down = ğŸ‘:people_body:hand_fingers_closed
raised fist = âœŠ:people_body:hand_fingers_closed
oncoming fist = ğŸ‘Š:people_body:hand_fingers_closed
left-facing fist = ğŸ¤›:people_body:hand_fingers_closed
right-facing fist = ğŸ¤œ:people_body:hand_fingers_closed
clapping hands = ğŸ‘:people_body:hands
raising hands = ğŸ™Œ:people_body:hands
heart hands = ğŸ«¶:people_body:hands
open hands = ğŸ‘:people_body:hands
palms up together = ğŸ¤²:people_body:hands
handshake = ğŸ¤:people_body:hands
folded hands = ğŸ™:people_body:hands
writing hand = âœ:people_body:hand_prop
nail polish = ğŸ’…:people_body:hand_prop
selfie = ğŸ¤³:people_body:hand_prop
flexed biceps = ğŸ’ª:people_body:body_parts
mechanical arm = ğŸ¦¾:people_body:body_parts
mechanical leg = ğŸ¦¿:people_body:body_parts
leg = ğŸ¦µ:people_body:body_parts
foot = ğŸ¦¶:people_body:body_parts
ear = ğŸ‘‚:people_body:body_parts
ear with hearing aid = ğŸ¦»:people_body:body_parts
nose = ğŸ‘ƒ:people_body:body_parts
brain = ğŸ§ :people_body:body_parts
anatomical heart = ğŸ«€:people_body:body_parts
lungs = ğŸ«:people_body:body_parts
tooth = ğŸ¦·:people_body:body_parts
bone = ğŸ¦´:people_body:body_parts
eyes = ğŸ‘€:people_body:body_parts
eye = ğŸ‘:people_body:body_parts
tongue = ğŸ‘…:people_body:body_parts
mouth = ğŸ‘„:people_body:body_parts
biting lip = ğŸ«¦:people_body:body_parts
baby = ğŸ‘¶:people_body:person
child = ğŸ§’:people_body:person
boy = ğŸ‘¦:people_body:person
girl = ğŸ‘§:people_body:person
person = ğŸ§‘:people_body:person
person: blond hair = ğŸ‘±:people_body:person
man = ğŸ‘¨:people_body:person
person: beard = ğŸ§”:people_body:person
man beard = ğŸ§”â€â™‚ï¸:people_body:person
man: beard = ğŸ§”â€â™‚:people_body:person
woman beard = ğŸ§”â€â™€ï¸:people_body:person
woman: beard = ğŸ§”â€â™€:people_body:person
man red hair = ğŸ‘¨â€ğŸ¦°:people_body:person
man curly hair = ğŸ‘¨â€ğŸ¦±:people_body:person
man white hair = ğŸ‘¨â€ğŸ¦³:people_body:person
man bald = ğŸ‘¨â€ğŸ¦²:people_body:person
woman = ğŸ‘©:people_body:person
woman red hair = ğŸ‘©â€ğŸ¦°:people_body:person
person red hair = ğŸ§‘â€ğŸ¦°:people_body:person
woman curly hair = ğŸ‘©â€ğŸ¦±:people_body:person
person curly hair = ğŸ§‘â€ğŸ¦±:people_body:person
woman white hair = ğŸ‘©â€ğŸ¦³:people_body:person
person white hair = ğŸ§‘â€ğŸ¦³:people_body:person
woman bald = ğŸ‘©â€ğŸ¦²:people_body:person
person bald = ğŸ§‘â€ğŸ¦²:people_body:person
woman blond hair = ğŸ‘±â€â™€ï¸:people_body:person
woman: blond hair = ğŸ‘±â€â™€:people_body:person
man blond hair = ğŸ‘±â€â™‚ï¸:people_body:person
man: blond hair = ğŸ‘±â€â™‚:people_body:person
older person = ğŸ§“:people_body:person
old man = ğŸ‘´:people_body:person
old woman = ğŸ‘µ:people_body:person
person frowning = ğŸ™:people_body:person_gesture
man frowning = ğŸ™â€â™‚:people_body:person_gesture
woman frowning = ğŸ™â€â™€:people_body:person_gesture
person pouting = ğŸ™:people_body:person_gesture
man pouting = ğŸ™â€â™‚:people_body:person_gesture
woman pouting = ğŸ™â€â™€:people_body:person_gesture
person gesturing NO = ğŸ™…:people_body:person_gesture
man gesturing NO = ğŸ™…â€â™‚:people_body:person_gesture
woman gesturing NO = ğŸ™…â€â™€:people_body:person_gesture
person gesturing OK = ğŸ™†:people_body:person_gesture
man gesturing OK = ğŸ™†â€â™‚:people_body:person_gesture
woman gesturing OK = ğŸ™†â€â™€:people_body:person_gesture
person tipping hand = ğŸ’:people_body:person_gesture
man tipping hand = ğŸ’â€â™‚:people_body:person_gesture
woman tipping hand = ğŸ’â€â™€:people_body:person_gesture
person raising hand = ğŸ™‹:people_body:person_gesture
man raising hand = ğŸ™‹â€â™‚:people_body:person_gesture
woman raising hand = ğŸ™‹â€â™€:people_body:person_gesture
deaf person = ğŸ§:people_body:person_gesture
deaf man = ğŸ§â€â™‚:people_body:person_gesture
deaf woman = ğŸ§â€â™€:people_body:person_gesture
person bowing = ğŸ™‡:people_body:person_gesture
man bowing = ğŸ™‡â€â™‚:people_body:person_gesture
woman bowing = ğŸ™‡â€â™€:people_body:person_gesture
person facepalming = ğŸ¤¦:people_body:person_gesture
man facepalming = ğŸ¤¦â€â™‚:people_body:person_gesture
woman facepalming = ğŸ¤¦â€â™€:people_body:person_gesture
person shrugging = ğŸ¤·:people_body:person_gesture
man shrugging = ğŸ¤·â€â™‚:people_body:person_gesture
woman shrugging = ğŸ¤·â€â™€:people_body:person_gesture
health worker = ğŸ§‘â€âš•:people_body:person_role
man health worker = ğŸ‘¨â€âš•:people_body:person_role
woman health worker = ğŸ‘©â€âš•:people_body:person_role
student = ğŸ§‘â€ğŸ“:people_body:person_role
man student = ğŸ‘¨â€ğŸ“:people_body:person_role
woman student = ğŸ‘©â€ğŸ“:people_body:person_role
teacher = ğŸ§‘â€ğŸ«:people_body:person_role
man teacher = ğŸ‘¨â€ğŸ«:people_body:person_role
woman teacher = ğŸ‘©â€ğŸ«:people_body:person_role
judge = ğŸ§‘â€âš–:people_body:person_role
man judge = ğŸ‘¨â€âš–:people_body:person_role
woman judge = ğŸ‘©â€âš–:people_body:person_role
farmer = ğŸ§‘â€ğŸŒ¾:people_body:person_role
man farmer = ğŸ‘¨â€ğŸŒ¾:people_body:person_role
woman farmer = ğŸ‘©â€ğŸŒ¾:people_body:person_role
cook = ğŸ§‘â€ğŸ³:people_body:person_role
man cook = ğŸ‘¨â€ğŸ³:people_body:person_role
woman cook = ğŸ‘©â€ğŸ³:people_body:person_role
mechanic = ğŸ§‘â€ğŸ”§:people_body:person_role
man mechanic = ğŸ‘¨â€ğŸ”§:people_body:person_role
woman mechanic = ğŸ‘©â€ğŸ”§:people_body:person_role
factory worker = ğŸ§‘â€ğŸ­:people_body:person_role
man factory worker = ğŸ‘¨â€ğŸ­:people_body:person_role
woman factory worker = ğŸ‘©â€ğŸ­:people_body:person_role
office worker = ğŸ§‘â€ğŸ’¼:people_body:person_role
man office worker = ğŸ‘¨â€ğŸ’¼:people_body:person_role
woman office worker = ğŸ‘©â€ğŸ’¼:people_body:person_role
scientist = ğŸ§‘â€ğŸ”¬:people_body:person_role
man scientist = ğŸ‘¨â€ğŸ”¬:people_body:person_role
woman scientist = ğŸ‘©â€ğŸ”¬:people_body:person_role
technologist = ğŸ§‘â€ğŸ’»:people_body:person_role
man technologist = ğŸ‘¨â€ğŸ’»:people_body:person_role
woman technologist = ğŸ‘©â€ğŸ’»:people_body:person_role
singer = ğŸ§‘â€ğŸ¤:people_body:person_role
man singer = ğŸ‘¨â€ğŸ¤:people_body:person_role
woman singer = ğŸ‘©â€ğŸ¤:people_body:person_role
artist = ğŸ§‘â€ğŸ¨:people_body:person_role
man artist = ğŸ‘¨â€ğŸ¨:people_body:person_role
woman artist = ğŸ‘©â€ğŸ¨:people_body:person_role
pilot = ğŸ§‘â€âœˆ:people_body:person_role
man pilot = ğŸ‘¨â€âœˆ:people_body:person_role
woman pilot = ğŸ‘©â€âœˆ:people_body:person_role
astronaut = ğŸ§‘â€ğŸš€:people_body:person_role
man astronaut = ğŸ‘¨â€ğŸš€:people_body:person_role
woman astronaut = ğŸ‘©â€ğŸš€:people_body:person_role
firefighter = ğŸ§‘â€ğŸš’:people_body:person_role
man firefighter = ğŸ‘¨â€ğŸš’:people_body:person_role
woman firefighter = ğŸ‘©â€ğŸš’:people_body:person_role
police officer = ğŸ‘®:people_body:person_role
man police officer = ğŸ‘®â€â™‚:people_body:person_role
woman police officer = ğŸ‘®â€â™€:people_body:person_role
detective = ğŸ•µ:people_body:person_role
man detective = ğŸ•µâ€â™‚:people_body:person_role
woman detective = ğŸ•µâ€â™€:people_body:person_role
guard = ğŸ’‚:people_body:person_role
man guard = ğŸ’‚â€â™‚:people_body:person_role
woman guard = ğŸ’‚â€â™€:people_body:person_role
ninja = ğŸ¥·:people_body:person_role
construction worker = ğŸ‘·:people_body:person_role
man construction worker = ğŸ‘·â€â™‚:people_body:person_role
woman construction worker = ğŸ‘·â€â™€:people_body:person_role
person with crown = ğŸ«…:people_body:person_role
prince = ğŸ¤´:people_body:person_role
princess = ğŸ‘¸:people_body:person_role
person wearing turban = ğŸ‘³:people_body:person_role
man wearing turban = ğŸ‘³â€â™‚:people_body:person_role
woman wearing turban = ğŸ‘³â€â™€:people_body:person_role
person with skullcap = ğŸ‘²:people_body:person_role
woman with headscarf = ğŸ§•:people_body:person_role
person in tuxedo = ğŸ¤µ:people_body:person_role
man in tuxedo = ğŸ¤µâ€â™‚:people_body:person_role
woman in tuxedo = ğŸ¤µâ€â™€:people_body:person_role
person with veil = ğŸ‘°:people_body:person_role
man with veil = ğŸ‘°â€â™‚:people_body:person_role
woman with veil = ğŸ‘°â€â™€:people_body:person_role
pregnant woman = ğŸ¤°:people_body:person_role
pregnant man = ğŸ«ƒ:people_body:person_role
pregnant person = ğŸ«„:people_body:person_role
breast-feeding = ğŸ¤±:people_body:person_role
woman feeding baby = ğŸ‘©â€ğŸ¼:people_body:person_role
man feeding baby = ğŸ‘¨â€ğŸ¼:people_body:person_role
person feeding baby = ğŸ§‘â€ğŸ¼:people_body:person_role
baby angel = ğŸ‘¼:people_body:person_fantasy
Santa Claus = ğŸ…:people_body:person_fantasy
Mrs. Claus = ğŸ¤¶:people_body:person_fantasy
mx claus = ğŸ§‘â€ğŸ„:people_body:person_fantasy
superhero = ğŸ¦¸:people_body:person_fantasy
man superhero = ğŸ¦¸â€â™‚:people_body:person_fantasy
woman superhero = ğŸ¦¸â€â™€:people_body:person_fantasy
supervillain = ğŸ¦¹:people_body:person_fantasy
man supervillain = ğŸ¦¹â€â™‚:people_body:person_fantasy
woman supervillain = ğŸ¦¹â€â™€:people_body:person_fantasy
mage = ğŸ§™:people_body:person_fantasy
man mage = ğŸ§™â€â™‚:people_body:person_fantasy
woman mage = ğŸ§™â€â™€:people_body:person_fantasy
fairy = ğŸ§š:people_body:person_fantasy
man fairy = ğŸ§šâ€â™‚:people_body:person_fantasy
woman fairy = ğŸ§šâ€â™€:people_body:person_fantasy
vampire = ğŸ§›:people_body:person_fantasy
man vampire = ğŸ§›â€â™‚:people_body:person_fantasy
woman vampire = ğŸ§›â€â™€:people_body:person_fantasy
merperson = ğŸ§œ:people_body:person_fantasy
merman = ğŸ§œâ€â™‚:people_body:person_fantasy
mermaid = ğŸ§œâ€â™€:people_body:person_fantasy
elf = ğŸ§:people_body:person_fantasy
man elf = ğŸ§â€â™‚:people_body:person_fantasy
woman elf = ğŸ§â€â™€:people_body:person_fantasy
genie = ğŸ§:people_body:person_fantasy
man genie = ğŸ§â€â™‚:people_body:person_fantasy
woman genie = ğŸ§â€â™€:people_body:person_fantasy
zombie = ğŸ§Ÿ:people_body:person_fantasy
man zombie = ğŸ§Ÿâ€â™‚:people_body:person_fantasy
woman zombie = ğŸ§Ÿâ€â™€:people_body:person_fantasy
troll = ğŸ§Œ:people_body:person_fantasy
person getting massage = ğŸ’†:people_body:person_activity
man getting massage = ğŸ’†â€â™‚:people_body:person_activity
woman getting massage = ğŸ’†â€â™€:people_body:person_activity
person getting haircut = ğŸ’‡:people_body:person_activity
man getting haircut = ğŸ’‡â€â™‚:people_body:person_activity
woman getting haircut = ğŸ’‡â€â™€:people_body:person_activity
person walking = ğŸš¶:people_body:person_activity
man walking = ğŸš¶â€â™‚:people_body:person_activity
woman walking = ğŸš¶â€â™€:people_body:person_activity
person standing = ğŸ§:people_body:person_activity
man standing = ğŸ§â€â™‚:people_body:person_activity
woman standing = ğŸ§â€â™€:people_body:person_activity
person kneeling = ğŸ§:people_body:person_activity
man kneeling = ğŸ§â€â™‚:people_body:person_activity
woman kneeling = ğŸ§â€â™€:people_body:person_activity
person with white cane = ğŸ§‘â€ğŸ¦¯:people_body:person_activity
man with white cane = ğŸ‘¨â€ğŸ¦¯:people_body:person_activity
woman with white cane = ğŸ‘©â€ğŸ¦¯:people_body:person_activity
person in motorized wheelchair = ğŸ§‘â€ğŸ¦¼:people_body:person_activity
man in motorized wheelchair = ğŸ‘¨â€ğŸ¦¼:people_body:person_activity
woman in motorized wheelchair = ğŸ‘©â€ğŸ¦¼:people_body:person_activity
person in manual wheelchair = ğŸ§‘â€ğŸ¦½:people_body:person_activity
man in manual wheelchair = ğŸ‘¨â€ğŸ¦½:people_body:person_activity
woman in manual wheelchair = ğŸ‘©â€ğŸ¦½:people_body:person_activity
person running = ğŸƒ:people_body:person_activity
man running = ğŸƒâ€â™‚:people_body:person_activity
woman running = ğŸƒâ€â™€:people_body:person_activity
woman dancing = ğŸ’ƒ:people_body:person_activity
man dancing = ğŸ•º:people_body:person_activity
person in suit levitating = ğŸ•´:people_body:person_activity
people with bunny ears = ğŸ‘¯:people_body:person_activity
men with bunny ears = ğŸ‘¯â€â™‚:people_body:person_activity
women with bunny ears = ğŸ‘¯â€â™€:people_body:person_activity
person in steamy room = ğŸ§–:people_body:person_activity
man in steamy room = ğŸ§–â€â™‚:people_body:person_activity
woman in steamy room = ğŸ§–â€â™€:people_body:person_activity
person climbing = ğŸ§—:people_body:person_activity
man climbing = ğŸ§—â€â™‚:people_body:person_activity
woman climbing = ğŸ§—â€â™€:people_body:person_activity
person fencing = ğŸ¤º:people_body:person_sport
horse racing = ğŸ‡:people_body:person_sport
skier = â›·:people_body:person_sport
snowboarder = ğŸ‚:people_body:person_sport
person golfing = ğŸŒ:people_body:person_sport
man golfing = ğŸŒâ€â™‚:people_body:person_sport
woman golfing = ğŸŒâ€â™€:people_body:person_sport
person surfing = ğŸ„:people_body:person_sport
man surfing = ğŸ„â€â™‚:people_body:person_sport
woman surfing = ğŸ„â€â™€:people_body:person_sport
person rowing boat = ğŸš£:people_body:person_sport
man rowing boat = ğŸš£â€â™‚:people_body:person_sport
woman rowing boat = ğŸš£â€â™€:people_body:person_sport
person swimming = ğŸŠ:people_body:person_sport
man swimming = ğŸŠâ€â™‚:people_body:person_sport
woman swimming = ğŸŠâ€â™€:people_body:person_sport
person bouncing ball = â›¹:people_body:person_sport
man bouncing ball = â›¹â€â™‚:people_body:person_sport
woman bouncing ball = â›¹â€â™€:people_body:person_sport
person lifting weights = ğŸ‹:people_body:person_sport
man lifting weights = ğŸ‹â€â™‚:people_body:person_sport
woman lifting weights = ğŸ‹â€â™€:people_body:person_sport
person biking = ğŸš´:people_body:person_sport
man biking = ğŸš´â€â™‚:people_body:person_sport
woman biking = ğŸš´â€â™€:people_body:person_sport
person mountain biking = ğŸšµ:people_body:person_sport
man mountain biking = ğŸšµâ€â™‚:people_body:person_sport
woman mountain biking = ğŸšµâ€â™€:people_body:person_sport
person cartwheeling = ğŸ¤¸:people_body:person_sport
man cartwheeling = ğŸ¤¸â€â™‚:people_body:person_sport
woman cartwheeling = ğŸ¤¸â€â™€:people_body:person_sport
people wrestling = ğŸ¤¼:people_body:person_sport
men wrestling = ğŸ¤¼â€â™‚:people_body:person_sport
women wrestling = ğŸ¤¼â€â™€:people_body:person_sport
person playing water polo = ğŸ¤½:people_body:person_sport
man playing water polo = ğŸ¤½â€â™‚:people_body:person_sport
woman playing water polo = ğŸ¤½â€â™€:people_body:person_sport
person playing handball = ğŸ¤¾:people_body:person_sport
man playing handball = ğŸ¤¾â€â™‚:people_body:person_sport
woman playing handball = ğŸ¤¾â€â™€:people_body:person_sport
person juggling = ğŸ¤¹:people_body:person_sport
man juggling = ğŸ¤¹â€â™‚:people_body:person_sport
woman juggling = ğŸ¤¹â€â™€:people_body:person_sport
person in lotus position = ğŸ§˜:people_body:person_resting
man in lotus position = ğŸ§˜â€â™‚:people_body:person_resting
woman in lotus position = ğŸ§˜â€â™€:people_body:person_resting
person taking bath = ğŸ›€:people_body:person_resting
person in bed = ğŸ›Œ:people_body:person_resting
people holding hands = ğŸ§‘â€ğŸ¤â€ğŸ§‘:people_body:family
women holding hands = ğŸ‘­:people_body:family
woman and man holding hands = ğŸ‘«:people_body:family
men holding hands = ğŸ‘¬:people_body:family
kiss = ğŸ’:people_body:family
kiss woman man = ğŸ‘©â€â¤â€ğŸ’‹â€ğŸ‘¨:people_body:family
kiss man man = ğŸ‘¨â€â¤â€ğŸ’‹â€ğŸ‘¨:people_body:family
kiss woman woman = ğŸ‘©â€â¤â€ğŸ’‹â€ğŸ‘©:people_body:family
couple with heart = ğŸ’‘:people_body:family
couple with heart woman man = ğŸ‘©â€â¤â€ğŸ‘¨:people_body:family
couple with heart man man = ğŸ‘¨â€â¤â€ğŸ‘¨:people_body:family
couple with heart woman woman = ğŸ‘©â€â¤â€ğŸ‘©:people_body:family
family = ğŸ‘ª:people_body:family
family man woman boy = ğŸ‘¨â€ğŸ‘©â€ğŸ‘¦:people_body:family
family man woman girl = ğŸ‘¨â€ğŸ‘©â€ğŸ‘§:people_body:family
family man woman girl boy = ğŸ‘¨â€ğŸ‘©â€ğŸ‘§â€ğŸ‘¦:people_body:family
family man woman boy boy = ğŸ‘¨â€ğŸ‘©â€ğŸ‘¦â€ğŸ‘¦:people_body:family
family man woman girl girl = ğŸ‘¨â€ğŸ‘©â€ğŸ‘§â€ğŸ‘§:people_body:family
family man man boy = ğŸ‘¨â€ğŸ‘¨â€ğŸ‘¦:people_body:family
family man man girl = ğŸ‘¨â€ğŸ‘¨â€ğŸ‘§:people_body:family
family man man girl boy = ğŸ‘¨â€ğŸ‘¨â€ğŸ‘§â€ğŸ‘¦:people_body:family
family man man boy boy = ğŸ‘¨â€ğŸ‘¨â€ğŸ‘¦â€ğŸ‘¦:people_body:family
family man man girl girl = ğŸ‘¨â€ğŸ‘¨â€ğŸ‘§â€ğŸ‘§:people_body:family
family woman woman boy = ğŸ‘©â€ğŸ‘©â€ğŸ‘¦:people_body:family
family woman woman girl = ğŸ‘©â€ğŸ‘©â€ğŸ‘§:people_body:family
family woman woman girl boy = ğŸ‘©â€ğŸ‘©â€ğŸ‘§â€ğŸ‘¦:people_body:family
family woman woman boy boy = ğŸ‘©â€ğŸ‘©â€ğŸ‘¦â€ğŸ‘¦:people_body:family
family woman woman girl girl = ğŸ‘©â€ğŸ‘©â€ğŸ‘§â€ğŸ‘§:people_body:family
family man boy = ğŸ‘¨â€ğŸ‘¦:people_body:family
family man boy boy = ğŸ‘¨â€ğŸ‘¦â€ğŸ‘¦:people_body:family
family man girl = ğŸ‘¨â€ğŸ‘§:people_body:family
family man girl boy = ğŸ‘¨â€ğŸ‘§â€ğŸ‘¦:people_body:family
family man girl girl = ğŸ‘¨â€ğŸ‘§â€ğŸ‘§:people_body:family
family woman boy = ğŸ‘©â€ğŸ‘¦:people_body:family
family woman boy boy = ğŸ‘©â€ğŸ‘¦â€ğŸ‘¦:people_body:family
family woman girl = ğŸ‘©â€ğŸ‘§:people_body:family
family woman girl boy = ğŸ‘©â€ğŸ‘§â€ğŸ‘¦:people_body:family
family woman girl girl = ğŸ‘©â€ğŸ‘§â€ğŸ‘§:people_body:family
speaking head = ğŸ—£:people_body:person_symbol
bust in silhouette = ğŸ‘¤:people_body:person_symbol
busts in silhouette = ğŸ‘¥:people_body:person_symbol
people hugging = ğŸ«‚:people_body:person_symbol
footprints = ğŸ‘£:people_body:person_symbol
monkey face = ğŸµ:animals_nature:animal_mammal
monkey = ğŸ’:animals_nature:animal_mammal
gorilla = ğŸ¦:animals_nature:animal_mammal
orangutan = ğŸ¦§:animals_nature:animal_mammal
dog face = ğŸ¶:animals_nature:animal_mammal
dog = ğŸ•:animals_nature:animal_mammal
guide dog = ğŸ¦®:animals_nature:animal_mammal
service dog = ğŸ•â€ğŸ¦º:animals_nature:animal_mammal
poodle = ğŸ©:animals_nature:animal_mammal
wolf = ğŸº:animals_nature:animal_mammal
fox = ğŸ¦Š:animals_nature:animal_mammal
raccoon = ğŸ¦:animals_nature:animal_mammal
cat face = ğŸ±:animals_nature:animal_mammal
cat = ğŸˆ:animals_nature:animal_mammal
black cat = ğŸˆâ€â¬›:animals_nature:animal_mammal
lion = ğŸ¦:animals_nature:animal_mammal
tiger face = ğŸ¯:animals_nature:animal_mammal
tiger = ğŸ…:animals_nature:animal_mammal
leopard = ğŸ†:animals_nature:animal_mammal
horse face = ğŸ´:animals_nature:animal_mammal
horse = ğŸ:animals_nature:animal_mammal
unicorn = ğŸ¦„:animals_nature:animal_mammal
zebra = ğŸ¦“:animals_nature:animal_mammal
deer = ğŸ¦Œ:animals_nature:animal_mammal
bison = ğŸ¦¬:animals_nature:animal_mammal
cow face = ğŸ®:animals_nature:animal_mammal
ox = ğŸ‚:animals_nature:animal_mammal
water buffalo = ğŸƒ:animals_nature:animal_mammal
cow = ğŸ„:animals_nature:animal_mammal
pig face = ğŸ·:animals_nature:animal_mammal
pig = ğŸ–:animals_nature:animal_mammal
boar = ğŸ—:animals_nature:animal_mammal
pig nose = ğŸ½:animals_nature:animal_mammal
ram = ğŸ:animals_nature:animal_mammal
ewe = ğŸ‘:animals_nature:animal_mammal
goat = ğŸ:animals_nature:animal_mammal
camel = ğŸª:animals_nature:animal_mammal
two-hump camel = ğŸ«:animals_nature:animal_mammal
llama = ğŸ¦™:animals_nature:animal_mammal
giraffe = ğŸ¦’:animals_nature:animal_mammal
elephant = ğŸ˜:animals_nature:animal_mammal
mammoth = ğŸ¦£:animals_nature:animal_mammal
rhinoceros = ğŸ¦:animals_nature:animal_mammal
hippopotamus = ğŸ¦›:animals_nature:animal_mammal
mouse face = ğŸ­:animals_nature:animal_mammal
mouse = ğŸ:animals_nature:animal_mammal
rat = ğŸ€:animals_nature:animal_mammal
hamster = ğŸ¹:animals_nature:animal_mammal
rabbit face = ğŸ°:animals_nature:animal_mammal
rabbit = ğŸ‡:animals_nature:animal_mammal
chipmunk = ğŸ¿:animals_nature:animal_mammal
beaver = ğŸ¦«:animals_nature:animal_mammal
hedgehog = ğŸ¦”:animals_nature:animal_mammal
bat = ğŸ¦‡:animals_nature:animal_mammal
bear = ğŸ»:animals_nature:animal_mammal
polar bear = ğŸ»â€â„:animals_nature:animal_mammal
koala = ğŸ¨:animals_nature:animal_mammal
panda = ğŸ¼:animals_nature:animal_mammal
sloth = ğŸ¦¥:animals_nature:animal_mammal
otter = ğŸ¦¦:animals_nature:animal_mammal
skunk = ğŸ¦¨:animals_nature:animal_mammal
kangaroo = ğŸ¦˜:animals_nature:animal_mammal
badger = ğŸ¦¡:animals_nature:animal_mammal
paw prints = ğŸ¾:animals_nature:animal_mammal
turkey = ğŸ¦ƒ:animals_nature:animal_bird
chicken = ğŸ”:animals_nature:animal_bird
rooster = ğŸ“:animals_nature:animal_bird
hatching chick = ğŸ£:animals_nature:animal_bird
baby chick = ğŸ¤:animals_nature:animal_bird
front-facing baby chick = ğŸ¥:animals_nature:animal_bird
bird = ğŸ¦:animals_nature:animal_bird
penguin = ğŸ§:animals_nature:animal_bird
dove = ğŸ•Š:animals_nature:animal_bird
eagle = ğŸ¦…:animals_nature:animal_bird
duck = ğŸ¦†:animals_nature:animal_bird
swan = ğŸ¦¢:animals_nature:animal_bird
owl = ğŸ¦‰:animals_nature:animal_bird
dodo = ğŸ¦¤:animals_nature:animal_bird
feather = ğŸª¶:animals_nature:animal_bird
flamingo = ğŸ¦©:animals_nature:animal_bird
peacock = ğŸ¦š:animals_nature:animal_bird
parrot = ğŸ¦œ:animals_nature:animal_bird
frog = ğŸ¸:animals_nature:animal_amphibian
crocodile = ğŸŠ:animals_nature:animal_reptile
turtle = ğŸ¢:animals_nature:animal_reptile
lizard = ğŸ¦:animals_nature:animal_reptile
snake = ğŸ:animals_nature:animal_reptile
dragon face = ğŸ²:animals_nature:animal_reptile
dragon = ğŸ‰:animals_nature:animal_reptile
sauropod = ğŸ¦•:animals_nature:animal_reptile
T-Rex = ğŸ¦–:animals_nature:animal_reptile
spouting whale = ğŸ³:animals_nature:animal_marine
whale = ğŸ‹:animals_nature:animal_marine
dolphin = ğŸ¬:animals_nature:animal_marine
seal = ğŸ¦­:animals_nature:animal_marine
fish = ğŸŸ:animals_nature:animal_marine
tropical fish = ğŸ :animals_nature:animal_marine
blowfish = ğŸ¡:animals_nature:animal_marine
shark = ğŸ¦ˆ:animals_nature:animal_marine
octopus = ğŸ™:animals_nature:animal_marine
spiral shell = ğŸš:animals_nature:animal_marine
coral = ğŸª¸:animals_nature:animal_marine
snail = ğŸŒ:animals_nature:animal_bug
butterfly = ğŸ¦‹:animals_nature:animal_bug
bug = ğŸ›:animals_nature:animal_bug
ant = ğŸœ:animals_nature:animal_bug
honeybee = ğŸ:animals_nature:animal_bug
beetle = ğŸª²:animals_nature:animal_bug
lady beetle = ğŸ:animals_nature:animal_bug
cricket = ğŸ¦—:animals_nature:animal_bug
cockroach = ğŸª³:animals_nature:animal_bug
spider = ğŸ•·:animals_nature:animal_bug
spider web = ğŸ•¸:animals_nature:animal_bug
scorpion = ğŸ¦‚:animals_nature:animal_bug
mosquito = ğŸ¦Ÿ:animals_nature:animal_bug
fly = ğŸª°:animals_nature:animal_bug
worm = ğŸª±:animals_nature:animal_bug
microbe = ğŸ¦ :animals_nature:animal_bug
bouquet = ğŸ’:animals_nature:plant_flower
cherry blossom = ğŸŒ¸:animals_nature:plant_flower
white flower = ğŸ’®:animals_nature:plant_flower
lotus = ğŸª·:animals_nature:plant_flower
rosette = ğŸµ:animals_nature:plant_flower
rose = ğŸŒ¹:animals_nature:plant_flower
wilted flower = ğŸ¥€:animals_nature:plant_flower
hibiscus = ğŸŒº:animals_nature:plant_flower
sunflower = ğŸŒ»:animals_nature:plant_flower
blossom = ğŸŒ¼:animals_nature:plant_flower
tulip = ğŸŒ·:animals_nature:plant_flower
seedling = ğŸŒ±:animals_nature:plant_other
potted plant = ğŸª´:animals_nature:plant_other
evergreen tree = ğŸŒ²:animals_nature:plant_other
deciduous tree = ğŸŒ³:animals_nature:plant_other
palm tree = ğŸŒ´:animals_nature:plant_other
cactus = ğŸŒµ:animals_nature:plant_other
sheaf of rice = ğŸŒ¾:animals_nature:plant_other
herb = ğŸŒ¿:animals_nature:plant_other
shamrock = â˜˜:animals_nature:plant_other
four leaf clover = ğŸ€:animals_nature:plant_other
maple leaf = ğŸ:animals_nature:plant_other
fallen leaf = ğŸ‚:animals_nature:plant_other
leaf fluttering in wind = ğŸƒ:animals_nature:plant_other
empty nest = ğŸª¹:animals_nature:plant_other
nest with eggs = ğŸªº:animals_nature:plant_other
grapes = ğŸ‡:food_drink:food_fruit
melon = ğŸˆ:food_drink:food_fruit
watermelon = ğŸ‰:food_drink:food_fruit
tangerine = ğŸŠ:food_drink:food_fruit
lemon = ğŸ‹:food_drink:food_fruit
banana = ğŸŒ:food_drink:food_fruit
pineapple = ğŸ:food_drink:food_fruit
mango = ğŸ¥­:food_drink:food_fruit
red apple = ğŸ:food_drink:food_fruit
green apple = ğŸ:food_drink:food_fruit
pear = ğŸ:food_drink:food_fruit
peach = ğŸ‘:food_drink:food_fruit
cherries = ğŸ’:food_drink:food_fruit
strawberry = ğŸ“:food_drink:food_fruit
blueberries = ğŸ«:food_drink:food_fruit
kiwi fruit = ğŸ¥:food_drink:food_fruit
tomato = ğŸ…:food_drink:food_fruit
olive = ğŸ«’:food_drink:food_fruit
coconut = ğŸ¥¥:food_drink:food_fruit
avocado = ğŸ¥‘:food_drink:food_vegetable
eggplant = ğŸ†:food_drink:food_vegetable
potato = ğŸ¥”:food_drink:food_vegetable
carrot = ğŸ¥•:food_drink:food_vegetable
ear of corn = ğŸŒ½:food_drink:food_vegetable
hot pepper = ğŸŒ¶:food_drink:food_vegetable
bell pepper = ğŸ«‘:food_drink:food_vegetable
cucumber = ğŸ¥’:food_drink:food_vegetable
leafy green = ğŸ¥¬:food_drink:food_vegetable
broccoli = ğŸ¥¦:food_drink:food_vegetable
garlic = ğŸ§„:food_drink:food_vegetable
onion = ğŸ§…:food_drink:food_vegetable
mushroom = ğŸ„:food_drink:food_vegetable
peanuts = ğŸ¥œ:food_drink:food_vegetable
beans = ğŸ«˜:food_drink:food_vegetable
chestnut = ğŸŒ°:food_drink:food_vegetable
bread = ğŸ:food_drink:food_prepared
croissant = ğŸ¥:food_drink:food_prepared
baguette bread = ğŸ¥–:food_drink:food_prepared
flatbread = ğŸ«“:food_drink:food_prepared
pretzel = ğŸ¥¨:food_drink:food_prepared
bagel = ğŸ¥¯:food_drink:food_prepared
pancakes = ğŸ¥:food_drink:food_prepared
waffle = ğŸ§‡:food_drink:food_prepared
cheese wedge = ğŸ§€:food_drink:food_prepared
meat on bone = ğŸ–:food_drink:food_prepared
poultry leg = ğŸ—:food_drink:food_prepared
cut of meat = ğŸ¥©:food_drink:food_prepared
bacon = ğŸ¥“:food_drink:food_prepared
hamburger = ğŸ”:food_drink:food_prepared
french fries = ğŸŸ:food_drink:food_prepared
pizza = ğŸ•:food_drink:food_prepared
hot dog = ğŸŒ­:food_drink:food_prepared
sandwich = ğŸ¥ª:food_drink:food_prepared
taco = ğŸŒ®:food_drink:food_prepared
burrito = ğŸŒ¯:food_drink:food_prepared
tamale = ğŸ«”:food_drink:food_prepared
stuffed flatbread = ğŸ¥™:food_drink:food_prepared
falafel = ğŸ§†:food_drink:food_prepared
egg = ğŸ¥š:food_drink:food_prepared
cooking = ğŸ³:food_drink:food_prepared
shallow pan of food = ğŸ¥˜:food_drink:food_prepared
pot of food = ğŸ²:food_drink:food_prepared
fondue = ğŸ«•:food_drink:food_prepared
bowl with spoon = ğŸ¥£:food_drink:food_prepared
green salad = ğŸ¥—:food_drink:food_prepared
popcorn = ğŸ¿:food_drink:food_prepared
butter = ğŸ§ˆ:food_drink:food_prepared
salt = ğŸ§‚:food_drink:food_prepared
canned food = ğŸ¥«:food_drink:food_prepared
bento box = ğŸ±:food_drink:food_asian
rice cracker = ğŸ˜:food_drink:food_asian
rice ball = ğŸ™:food_drink:food_asian
cooked rice = ğŸš:food_drink:food_asian
curry rice = ğŸ›:food_drink:food_asian
steaming bowl = ğŸœ:food_drink:food_asian
spaghetti = ğŸ:food_drink:food_asian
roasted sweet potato = ğŸ :food_drink:food_asian
oden = ğŸ¢:food_drink:food_asian
sushi = ğŸ£:food_drink:food_asian
fried shrimp = ğŸ¤:food_drink:food_asian
fish cake with swirl = ğŸ¥:food_drink:food_asian
moon cake = ğŸ¥®:food_drink:food_asian
dango = ğŸ¡:food_drink:food_asian
dumpling = ğŸ¥Ÿ:food_drink:food_asian
fortune cookie = ğŸ¥ :food_drink:food_asian
takeout box = ğŸ¥¡:food_drink:food_asian
crab = ğŸ¦€:food_drink:food_marine
lobster = ğŸ¦:food_drink:food_marine
shrimp = ğŸ¦:food_drink:food_marine
squid = ğŸ¦‘:food_drink:food_marine
oyster = ğŸ¦ª:food_drink:food_marine
soft ice cream = ğŸ¦:food_drink:food_sweet
shaved ice = ğŸ§:food_drink:food_sweet
ice cream = ğŸ¨:food_drink:food_sweet
doughnut = ğŸ©:food_drink:food_sweet
cookie = ğŸª:food_drink:food_sweet
birthday cake = ğŸ‚:food_drink:food_sweet
shortcake = ğŸ°:food_drink:food_sweet
cupcake = ğŸ§:food_drink:food_sweet
pie = ğŸ¥§:food_drink:food_sweet
chocolate bar = ğŸ«:food_drink:food_sweet
candy = ğŸ¬:food_drink:food_sweet
lollipop = ğŸ­:food_drink:food_sweet
custard = ğŸ®:food_drink:food_sweet
honey pot = ğŸ¯:food_drink:food_sweet
baby bottle = ğŸ¼:food_drink:drink
glass of milk = ğŸ¥›:food_drink:drink
hot beverage = â˜•:food_drink:drink
teapot = ğŸ«–:food_drink:drink
teacup without handle = ğŸµ:food_drink:drink
sake = ğŸ¶:food_drink:drink
bottle with popping cork = ğŸ¾:food_drink:drink
wine glass = ğŸ·:food_drink:drink
cocktail glass = ğŸ¸:food_drink:drink
tropical drink = ğŸ¹:food_drink:drink
beer mug = ğŸº:food_drink:drink
clinking beer mugs = ğŸ»:food_drink:drink
clinking glasses = ğŸ¥‚:food_drink:drink
tumbler glass = ğŸ¥ƒ:food_drink:drink
pouring liquid = ğŸ«—:food_drink:drink
cup with straw = ğŸ¥¤:food_drink:drink
bubble tea = ğŸ§‹:food_drink:drink
beverage box = ğŸ§ƒ:food_drink:drink
mate = ğŸ§‰:food_drink:drink
ice = ğŸ§Š:food_drink:drink
chopsticks = ğŸ¥¢:food_drink:dishware
fork and knife with plate = ğŸ½:food_drink:dishware
fork and knife = ğŸ´:food_drink:dishware
spoon = ğŸ¥„:food_drink:dishware
kitchen knife = ğŸ”ª:food_drink:dishware
jar = ğŸ«™:food_drink:dishware
amphora = ğŸº:food_drink:dishware
globe showing Europe-Africa = ğŸŒ:travel_places:place_map
globe showing Americas = ğŸŒ:travel_places:place_map
globe showing Asia-Australia = ğŸŒ:travel_places:place_map
globe with meridians = ğŸŒ:travel_places:place_map
world map = ğŸ—º:travel_places:place_map
map of Japan = ğŸ—¾:travel_places:place_map
compass = ğŸ§­:travel_places:place_map
snow-capped mountain = ğŸ”:travel_places:place_geographic
mountain = â›°:travel_places:place_geographic
volcano = ğŸŒ‹:travel_places:place_geographic
mount fuji = ğŸ—»:travel_places:place_geographic
camping = ğŸ•:travel_places:place_geographic
beach with umbrella = ğŸ–:travel_places:place_geographic
desert = ğŸœ:travel_places:place_geographic
desert island = ğŸ:travel_places:place_geographic
national park = ğŸ:travel_places:place_geographic
stadium = ğŸŸ:travel_places:place_building
classical building = ğŸ›:travel_places:place_building
building construction = ğŸ—:travel_places:place_building
brick = ğŸ§±:travel_places:place_building
rock = ğŸª¨:travel_places:place_building
wood = ğŸªµ:travel_places:place_building
hut = ğŸ›–:travel_places:place_building
houses = ğŸ˜:travel_places:place_building
derelict house = ğŸš:travel_places:place_building
house = ğŸ :travel_places:place_building
house with garden = ğŸ¡:travel_places:place_building
office building = ğŸ¢:travel_places:place_building
Japanese post office = ğŸ£:travel_places:place_building
post office = ğŸ¤:travel_places:place_building
hospital = ğŸ¥:travel_places:place_building
bank = ğŸ¦:travel_places:place_building
hotel = ğŸ¨:travel_places:place_building
love hotel = ğŸ©:travel_places:place_building
convenience store = ğŸª:travel_places:place_building
school = ğŸ«:travel_places:place_building
department store = ğŸ¬:travel_places:place_building
factory = ğŸ­:travel_places:place_building
Japanese castle = ğŸ¯:travel_places:place_building
castle = ğŸ°:travel_places:place_building
wedding = ğŸ’’:travel_places:place_building
Tokyo tower = ğŸ—¼:travel_places:place_building
Statue of Liberty = ğŸ—½:travel_places:place_building
church = â›ª:travel_places:place_religious
mosque = ğŸ•Œ:travel_places:place_religious
hindu temple = ğŸ›•:travel_places:place_religious
synagogue = ğŸ•:travel_places:place_religious
shinto shrine = â›©:travel_places:place_religious
kaaba = ğŸ•‹:travel_places:place_religious
fountain = â›²:travel_places:place_other
tent = â›º:travel_places:place_other
foggy = ğŸŒ:travel_places:place_other
night with stars = ğŸŒƒ:travel_places:place_other
cityscape = ğŸ™:travel_places:place_other
sunrise over mountains = ğŸŒ„:travel_places:place_other
sunrise = ğŸŒ…:travel_places:place_other
cityscape at dusk = ğŸŒ†:travel_places:place_other
sunset = ğŸŒ‡:travel_places:place_other
bridge at night = ğŸŒ‰:travel_places:place_other
hot springs = â™¨:travel_places:place_other
carousel horse = ğŸ :travel_places:place_other
playground slide = ğŸ›:travel_places:place_other
ferris wheel = ğŸ¡:travel_places:place_other
roller coaster = ğŸ¢:travel_places:place_other
barber pole = ğŸ’ˆ:travel_places:place_other
circus tent = ğŸª:travel_places:place_other
locomotive = ğŸš‚:travel_places:transport_ground
railway car = ğŸšƒ:travel_places:transport_ground
high-speed train = ğŸš„:travel_places:transport_ground
bullet train = ğŸš…:travel_places:transport_ground
train = ğŸš†:travel_places:transport_ground
metro = ğŸš‡:travel_places:transport_ground
light rail = ğŸšˆ:travel_places:transport_ground
station = ğŸš‰:travel_places:transport_ground
tram = ğŸšŠ:travel_places:transport_ground
monorail = ğŸš:travel_places:transport_ground
mountain railway = ğŸš:travel_places:transport_ground
tram car = ğŸš‹:travel_places:transport_ground
bus = ğŸšŒ:travel_places:transport_ground
oncoming bus = ğŸš:travel_places:transport_ground
trolleybus = ğŸš:travel_places:transport_ground
minibus = ğŸš:travel_places:transport_ground
ambulance = ğŸš‘:travel_places:transport_ground
fire engine = ğŸš’:travel_places:transport_ground
police car = ğŸš“:travel_places:transport_ground
oncoming police car = ğŸš”:travel_places:transport_ground
taxi = ğŸš•:travel_places:transport_ground
oncoming taxi = ğŸš–:travel_places:transport_ground
automobile = ğŸš—:travel_places:transport_ground
oncoming automobile = ğŸš˜:travel_places:transport_ground
sport utility vehicle = ğŸš™:travel_places:transport_ground
pickup truck = ğŸ›»:travel_places:transport_ground
delivery truck = ğŸšš:travel_places:transport_ground
articulated lorry = ğŸš›:travel_places:transport_ground
tractor = ğŸšœ:travel_places:transport_ground
racing car = ğŸ:travel_places:transport_ground
motorcycle = ğŸ:travel_places:transport_ground
motor scooter = ğŸ›µ:travel_places:transport_ground
manual wheelchair = ğŸ¦½:travel_places:transport_ground
motorized wheelchair = ğŸ¦¼:travel_places:transport_ground
auto rickshaw = ğŸ›º:travel_places:transport_ground
bicycle = ğŸš²:travel_places:transport_ground
kick scooter = ğŸ›´:travel_places:transport_ground
skateboard = ğŸ›¹:travel_places:transport_ground
roller skate = ğŸ›¼:travel_places:transport_ground
bus stop = ğŸš:travel_places:transport_ground
motorway = ğŸ›£:travel_places:transport_ground
railway track = ğŸ›¤:travel_places:transport_ground
oil drum = ğŸ›¢:travel_places:transport_ground
fuel pump = â›½:travel_places:transport_ground
wheel = ğŸ›:travel_places:transport_ground
police car light = ğŸš¨:travel_places:transport_ground
horizontal traffic light = ğŸš¥:travel_places:transport_ground
vertical traffic light = ğŸš¦:travel_places:transport_ground
stop sign = ğŸ›‘:travel_places:transport_ground
construction = ğŸš§:travel_places:transport_ground
anchor = âš“:travel_places:transport_water
ring buoy = ğŸ›Ÿ:travel_places:transport_water
sailboat = â›µ:travel_places:transport_water
canoe = ğŸ›¶:travel_places:transport_water
speedboat = ğŸš¤:travel_places:transport_water
passenger ship = ğŸ›³:travel_places:transport_water
ferry = â›´:travel_places:transport_water
motor boat = ğŸ›¥:travel_places:transport_water
ship = ğŸš¢:travel_places:transport_water
airplane = âœˆ:travel_places:transport_air
small airplane = ğŸ›©:travel_places:transport_air
airplane departure = ğŸ›«:travel_places:transport_air
airplane arrival = ğŸ›¬:travel_places:transport_air
parachute = ğŸª‚:travel_places:transport_air
seat = ğŸ’º:travel_places:transport_air
helicopter = ğŸš:travel_places:transport_air
suspension railway = ğŸšŸ:travel_places:transport_air
mountain cableway = ğŸš :travel_places:transport_air
aerial tramway = ğŸš¡:travel_places:transport_air
satellite = ğŸ›°:travel_places:transport_air
rocket = ğŸš€:travel_places:transport_air
flying saucer = ğŸ›¸:travel_places:transport_air
bellhop bell = ğŸ›:travel_places:hotel
luggage = ğŸ§³:travel_places:hotel
hourglass done = âŒ›:travel_places:time
hourglass not done = â³:travel_places:time
watch = âŒš:travel_places:time
alarm clock = â°:travel_places:time
stopwatch = â±:travel_places:time
timer clock = â²:travel_places:time
mantelpiece clock = ğŸ•°:travel_places:time
twelve oâ€™clock = ğŸ•›:travel_places:time
twelve-thirty = ğŸ•§:travel_places:time
one oâ€™clock = ğŸ•:travel_places:time
one-thirty = ğŸ•œ:travel_places:time
two oâ€™clock = ğŸ•‘:travel_places:time
two-thirty = ğŸ•:travel_places:time
three oâ€™clock = ğŸ•’:travel_places:time
three-thirty = ğŸ•:travel_places:time
four oâ€™clock = ğŸ•“:travel_places:time
four-thirty = ğŸ•Ÿ:travel_places:time
five oâ€™clock = ğŸ•”:travel_places:time
five-thirty = ğŸ• :travel_places:time
six oâ€™clock = ğŸ••:travel_places:time
six-thirty = ğŸ•¡:travel_places:time
seven oâ€™clock = ğŸ•–:travel_places:time
seven-thirty = ğŸ•¢:travel_places:time
eight oâ€™clock = ğŸ•—:travel_places:time
eight-thirty = ğŸ•£:travel_places:time
nine oâ€™clock = ğŸ•˜:travel_places:time
nine-thirty = ğŸ•¤:travel_places:time
ten oâ€™clock = ğŸ•™:travel_places:time
ten-thirty = ğŸ•¥:travel_places:time
eleven oâ€™clock = ğŸ•š:travel_places:time
eleven-thirty = ğŸ•¦:travel_places:time
new moon = ğŸŒ‘:travel_places:sky_weather
waxing crescent moon = ğŸŒ’:travel_places:sky_weather
first quarter moon = ğŸŒ“:travel_places:sky_weather
waxing gibbous moon = ğŸŒ”:travel_places:sky_weather
full moon = ğŸŒ•:travel_places:sky_weather
waning gibbous moon = ğŸŒ–:travel_places:sky_weather
last quarter moon = ğŸŒ—:travel_places:sky_weather
waning crescent moon = ğŸŒ˜:travel_places:sky_weather
crescent moon = ğŸŒ™:travel_places:sky_weather
new moon face = ğŸŒš:travel_places:sky_weather
first quarter moon face = ğŸŒ›:travel_places:sky_weather
last quarter moon face = ğŸŒœ:travel_places:sky_weather
thermometer = ğŸŒ¡:travel_places:sky_weather
sun = â˜€:travel_places:sky_weather
full moon face = ğŸŒ:travel_places:sky_weather
sun with face = ğŸŒ:travel_places:sky_weather
ringed planet = ğŸª:travel_places:sky_weather
star = â­:travel_places:sky_weather
glowing star = ğŸŒŸ:travel_places:sky_weather
shooting star = ğŸŒ :travel_places:sky_weather
milky way = ğŸŒŒ:travel_places:sky_weather
cloud = â˜:travel_places:sky_weather
sun behind cloud = â›…:travel_places:sky_weather
cloud with lightning and rain = â›ˆ:travel_places:sky_weather
sun behind small cloud = ğŸŒ¤:travel_places:sky_weather
sun behind large cloud = ğŸŒ¥:travel_places:sky_weather
sun behind rain cloud = ğŸŒ¦:travel_places:sky_weather
cloud with rain = ğŸŒ§:travel_places:sky_weather
cloud with snow = ğŸŒ¨:travel_places:sky_weather
cloud with lightning = ğŸŒ©:travel_places:sky_weather
tornado = ğŸŒª:travel_places:sky_weather
fog = ğŸŒ«:travel_places:sky_weather
wind face = ğŸŒ¬:travel_places:sky_weather
cyclone = ğŸŒ€:travel_places:sky_weather
rainbow = ğŸŒˆ:travel_places:sky_weather
closed umbrella = ğŸŒ‚:travel_places:sky_weather
umbrella = â˜‚:travel_places:sky_weather
umbrella with rain drops = â˜”:travel_places:sky_weather
umbrella on ground = â›±:travel_places:sky_weather
high voltage = âš¡:travel_places:sky_weather
snowflake = â„:travel_places:sky_weather
snowman = â˜ƒ:travel_places:sky_weather
snowman without snow = â›„:travel_places:sky_weather
comet = â˜„:travel_places:sky_weather
fire = ğŸ”¥:travel_places:sky_weather
droplet = ğŸ’§:travel_places:sky_weather
water wave = ğŸŒŠ:travel_places:sky_weather
jack-o-lantern = ğŸƒ:activities:event
Christmas tree = ğŸ„:activities:event
fireworks = ğŸ†:activities:event
sparkler = ğŸ‡:activities:event
firecracker = ğŸ§¨:activities:event
sparkles = âœ¨:activities:event
balloon = ğŸˆ:activities:event
party popper = ğŸ‰:activities:event
confetti ball = ğŸŠ:activities:event
tanabata tree = ğŸ‹:activities:event
pine decoration = ğŸ:activities:event
Japanese dolls = ğŸ:activities:event
carp streamer = ğŸ:activities:event
wind chime = ğŸ:activities:event
moon viewing ceremony = ğŸ‘:activities:event
red envelope = ğŸ§§:activities:event
ribbon = ğŸ€:activities:event
wrapped gift = ğŸ:activities:event
reminder ribbon = ğŸ—:activities:event
admission tickets = ğŸŸ:activities:event
ticket = ğŸ«:activities:event
military medal = ğŸ–:activities:award_medal
trophy = ğŸ†:activities:award_medal
sports medal = ğŸ…:activities:award_medal
1st place medal = ğŸ¥‡:activities:award_medal
2nd place medal = ğŸ¥ˆ:activities:award_medal
3rd place medal = ğŸ¥‰:activities:award_medal
soccer ball = âš½:activities:sport
baseball = âš¾:activities:sport
softball = ğŸ¥:activities:sport
basketball = ğŸ€:activities:sport
volleyball = ğŸ:activities:sport
american football = ğŸˆ:activities:sport
rugby football = ğŸ‰:activities:sport
tennis = ğŸ¾:activities:sport
flying disc = ğŸ¥:activities:sport
bowling = ğŸ³:activities:sport
cricket game = ğŸ:activities:sport
field hockey = ğŸ‘:activities:sport
ice hockey = ğŸ’:activities:sport
lacrosse = ğŸ¥:activities:sport
ping pong = ğŸ“:activities:sport
badminton = ğŸ¸:activities:sport
boxing glove = ğŸ¥Š:activities:sport
martial arts uniform = ğŸ¥‹:activities:sport
goal net = ğŸ¥…:activities:sport
flag in hole = â›³:activities:sport
ice skate = â›¸:activities:sport
fishing pole = ğŸ£:activities:sport
diving mask = ğŸ¤¿:activities:sport
running shirt = ğŸ½:activities:sport
skis = ğŸ¿:activities:sport
sled = ğŸ›·:activities:sport
curling stone = ğŸ¥Œ:activities:sport
bullseye = ğŸ¯:activities:game
yo-yo = ğŸª€:activities:game
kite = ğŸª:activities:game
pool 8 ball = ğŸ±:activities:game
crystal ball = ğŸ”®:activities:game
magic wand = ğŸª„:activities:game
nazar amulet = ğŸ§¿:activities:game
hamsa = ğŸª¬:activities:game
video game = ğŸ®:activities:game
joystick = ğŸ•¹:activities:game
slot machine = ğŸ°:activities:game
game die = ğŸ²:activities:game
puzzle piece = ğŸ§©:activities:game
teddy bear = ğŸ§¸:activities:game
piÃ±ata = ğŸª…:activities:game
mirror ball = ğŸª©:activities:game
nesting dolls = ğŸª†:activities:game
spade suit = â™ :activities:game
heart suit = â™¥:activities:game
diamond suit = â™¦:activities:game
club suit = â™£:activities:game
chess pawn = â™Ÿ:activities:game
joker = ğŸƒ:activities:game
mahjong red dragon = ğŸ€„:activities:game
flower playing cards = ğŸ´:activities:game
performing arts = ğŸ­:activities:arts_crafts
framed picture = ğŸ–¼:activities:arts_crafts
artist palette = ğŸ¨:activities:arts_crafts
thread = ğŸ§µ:activities:arts_crafts
sewing needle = ğŸª¡:activities:arts_crafts
yarn = ğŸ§¶:activities:arts_crafts
knot = ğŸª¢:activities:arts_crafts
glasses = ğŸ‘“:objects:clothing
sunglasses = ğŸ•¶:objects:clothing
goggles = ğŸ¥½:objects:clothing
lab coat = ğŸ¥¼:objects:clothing
safety vest = ğŸ¦º:objects:clothing
necktie = ğŸ‘”:objects:clothing
t-shirt = ğŸ‘•:objects:clothing
jeans = ğŸ‘–:objects:clothing
scarf = ğŸ§£:objects:clothing
gloves = ğŸ§¤:objects:clothing
coat = ğŸ§¥:objects:clothing
socks = ğŸ§¦:objects:clothing
dress = ğŸ‘—:objects:clothing
kimono = ğŸ‘˜:objects:clothing
sari = ğŸ¥»:objects:clothing
one-piece swimsuit = ğŸ©±:objects:clothing
briefs = ğŸ©²:objects:clothing
shorts = ğŸ©³:objects:clothing
bikini = ğŸ‘™:objects:clothing
womanâ€™s clothes = ğŸ‘š:objects:clothing
purse = ğŸ‘›:objects:clothing
handbag = ğŸ‘œ:objects:clothing
clutch bag = ğŸ‘:objects:clothing
shopping bags = ğŸ›:objects:clothing
backpack = ğŸ’:objects:clothing
thong sandal = ğŸ©´:objects:clothing
manâ€™s shoe = ğŸ‘:objects:clothing
running shoe = ğŸ‘Ÿ:objects:clothing
hiking boot = ğŸ¥¾:objects:clothing
flat shoe = ğŸ¥¿:objects:clothing
high-heeled shoe = ğŸ‘ :objects:clothing
womanâ€™s sandal = ğŸ‘¡:objects:clothing
ballet shoes = ğŸ©°:objects:clothing
womanâ€™s boot = ğŸ‘¢:objects:clothing
crown = ğŸ‘‘:objects:clothing
womanâ€™s hat = ğŸ‘’:objects:clothing
top hat = ğŸ©:objects:clothing
graduation cap = ğŸ“:objects:clothing
billed cap = ğŸ§¢:objects:clothing
military helmet = ğŸª–:objects:clothing
rescue workerâ€™s helmet = â›‘:objects:clothing
prayer beads = ğŸ“¿:objects:clothing
lipstick = ğŸ’„:objects:clothing
ring = ğŸ’:objects:clothing
gem stone = ğŸ’:objects:clothing
muted speaker = ğŸ”‡:objects:sound
speaker low volume = ğŸ”ˆ:objects:sound
speaker medium volume = ğŸ”‰:objects:sound
speaker high volume = ğŸ”Š:objects:sound
loudspeaker = ğŸ“¢:objects:sound
megaphone = ğŸ“£:objects:sound
postal horn = ğŸ“¯:objects:sound
bell = ğŸ””:objects:sound
bell with slash = ğŸ”•:objects:sound
musical score = ğŸ¼:objects:music
musical note = ğŸµ:objects:music
musical notes = ğŸ¶:objects:music
studio microphone = ğŸ™:objects:music
level slider = ğŸš:objects:music
control knobs = ğŸ›:objects:music
microphone = ğŸ¤:objects:music
headphone = ğŸ§:objects:music
radio = ğŸ“»:objects:music
saxophone = ğŸ·:objects:musical_instrument
accordion = ğŸª—:objects:musical_instrument
guitar = ğŸ¸:objects:musical_instrument
musical keyboard = ğŸ¹:objects:musical_instrument
trumpet = ğŸº:objects:musical_instrument
violin = ğŸ»:objects:musical_instrument
banjo = ğŸª•:objects:musical_instrument
drum = ğŸ¥:objects:musical_instrument
long drum = ğŸª˜:objects:musical_instrument
mobile phone = ğŸ“±:objects:phone
mobile phone with arrow = ğŸ“²:objects:phone
telephone = â˜:objects:phone
telephone receiver = ğŸ“:objects:phone
pager = ğŸ“Ÿ:objects:phone
fax machine = ğŸ“ :objects:phone
battery = ğŸ”‹:objects:computer
low battery = ğŸª«:objects:computer
electric plug = ğŸ”Œ:objects:computer
laptop = ğŸ’»:objects:computer
desktop computer = ğŸ–¥:objects:computer
printer = ğŸ–¨:objects:computer
keyboard = âŒ¨:objects:computer
computer mouse = ğŸ–±:objects:computer
trackball = ğŸ–²:objects:computer
computer disk = ğŸ’½:objects:computer
floppy disk = ğŸ’¾:objects:computer
optical disk = ğŸ’¿:objects:computer
dvd = ğŸ“€:objects:computer
abacus = ğŸ§®:objects:computer
movie camera = ğŸ¥:objects:light_video
film frames = ğŸ:objects:light_video
film projector = ğŸ“½:objects:light_video
clapper board = ğŸ¬:objects:light_video
television = ğŸ“º:objects:light_video
camera = ğŸ“·:objects:light_video
camera with flash = ğŸ“¸:objects:light_video
video camera = ğŸ“¹:objects:light_video
videocassette = ğŸ“¼:objects:light_video
magnifying glass tilted left = ğŸ”:objects:light_video
magnifying glass tilted right = ğŸ”:objects:light_video
candle = ğŸ•¯:objects:light_video
light bulb = ğŸ’¡:objects:light_video
flashlight = ğŸ”¦:objects:light_video
red paper lantern = ğŸ®:objects:light_video
diya lamp = ğŸª”:objects:light_video
notebook with decorative cover = ğŸ“”:objects:book_paper
closed book = ğŸ“•:objects:book_paper
open book = ğŸ“–:objects:book_paper
green book = ğŸ“—:objects:book_paper
blue book = ğŸ“˜:objects:book_paper
orange book = ğŸ“™:objects:book_paper
books = ğŸ“š:objects:book_paper
notebook = ğŸ““:objects:book_paper
ledger = ğŸ“’:objects:book_paper
page with curl = ğŸ“ƒ:objects:book_paper
scroll = ğŸ“œ:objects:book_paper
page facing up = ğŸ“„:objects:book_paper
newspaper = ğŸ“°:objects:book_paper
rolled-up newspaper = ğŸ—:objects:book_paper
bookmark tabs = ğŸ“‘:objects:book_paper
bookmark = ğŸ”–:objects:book_paper
label = ğŸ·:objects:book_paper
money bag = ğŸ’°:objects:money
coin = ğŸª™:objects:money
yen banknote = ğŸ’´:objects:money
dollar banknote = ğŸ’µ:objects:money
euro banknote = ğŸ’¶:objects:money
pound banknote = ğŸ’·:objects:money
money with wings = ğŸ’¸:objects:money
credit card = ğŸ’³:objects:money
receipt = ğŸ§¾:objects:money
chart increasing with yen = ğŸ’¹:objects:money
envelope = âœ‰:objects:mail
e-mail = ğŸ“§:objects:mail
incoming envelope = ğŸ“¨:objects:mail
envelope with arrow = ğŸ“©:objects:mail
outbox tray = ğŸ“¤:objects:mail
inbox tray = ğŸ“¥:objects:mail
package = ğŸ“¦:objects:mail
closed mailbox with raised flag = ğŸ“«:objects:mail
closed mailbox with lowered flag = ğŸ“ª:objects:mail
open mailbox with raised flag = ğŸ“¬:objects:mail
open mailbox with lowered flag = ğŸ“­:objects:mail
postbox = ğŸ“®:objects:mail
ballot box with ballot = ğŸ—³:objects:mail
pencil = âœ:objects:writing
black nib = âœ’:objects:writing
fountain pen = ğŸ–‹:objects:writing
pen = ğŸ–Š:objects:writing
paintbrush = ğŸ–Œ:objects:writing
crayon = ğŸ–:objects:writing
memo = ğŸ“:objects:writing
briefcase = ğŸ’¼:objects:office
file folder = ğŸ“:objects:office
open file folder = ğŸ“‚:objects:office
card index dividers = ğŸ—‚:objects:office
calendar = ğŸ“…:objects:office
tear-off calendar = ğŸ“†:objects:office
spiral notepad = ğŸ—’:objects:office
spiral calendar = ğŸ—“:objects:office
card index = ğŸ“‡:objects:office
chart increasing = ğŸ“ˆ:objects:office
chart decreasing = ğŸ“‰:objects:office
bar chart = ğŸ“Š:objects:office
clipboard = ğŸ“‹:objects:office
pushpin = ğŸ“Œ:objects:office
round pushpin = ğŸ“:objects:office
paperclip = ğŸ“:objects:office
linked paperclips = ğŸ–‡:objects:office
straight ruler = ğŸ“:objects:office
triangular ruler = ğŸ“:objects:office
scissors = âœ‚:objects:office
card file box = ğŸ—ƒ:objects:office
file cabinet = ğŸ—„:objects:office
wastebasket = ğŸ—‘:objects:office
locked = ğŸ”’:objects:lock
unlocked = ğŸ”“:objects:lock
locked with pen = ğŸ”:objects:lock
locked with key = ğŸ”:objects:lock
key = ğŸ”‘:objects:lock
old key = ğŸ—:objects:lock
hammer = ğŸ”¨:objects:tool
axe = ğŸª“:objects:tool
pick = â›:objects:tool
hammer and pick = âš’:objects:tool
hammer and wrench = ğŸ› :objects:tool
dagger = ğŸ—¡:objects:tool
crossed swords = âš”:objects:tool
water pistol = ğŸ”«:objects:tool
boomerang = ğŸªƒ:objects:tool
bow and arrow = ğŸ¹:objects:tool
shield = ğŸ›¡:objects:tool
carpentry saw = ğŸªš:objects:tool
wrench = ğŸ”§:objects:tool
screwdriver = ğŸª›:objects:tool
nut and bolt = ğŸ”©:objects:tool
gear = âš™:objects:tool
clamp = ğŸ—œ:objects:tool
balance scale = âš–:objects:tool
white cane = ğŸ¦¯:objects:tool
link = ğŸ”—:objects:tool
chains = â›“:objects:tool
hook = ğŸª:objects:tool
toolbox = ğŸ§°:objects:tool
magnet = ğŸ§²:objects:tool
ladder = ğŸªœ:objects:tool
alembic = âš—:objects:science
test tube = ğŸ§ª:objects:science
petri dish = ğŸ§«:objects:science
dna = ğŸ§¬:objects:science
microscope = ğŸ”¬:objects:science
telescope = ğŸ”­:objects:science
satellite antenna = ğŸ“¡:objects:science
syringe = ğŸ’‰:objects:medical
drop of blood = ğŸ©¸:objects:medical
pill = ğŸ’Š:objects:medical
adhesive bandage = ğŸ©¹:objects:medical
crutch = ğŸ©¼:objects:medical
stethoscope = ğŸ©º:objects:medical
x-ray = ğŸ©»:objects:medical
door = ğŸšª:objects:household
elevator = ğŸ›—:objects:household
mirror = ğŸª:objects:household
window = ğŸªŸ:objects:household
bed = ğŸ›:objects:household
couch and lamp = ğŸ›‹:objects:household
chair = ğŸª‘:objects:household
toilet = ğŸš½:objects:household
plunger = ğŸª :objects:household
shower = ğŸš¿:objects:household
bathtub = ğŸ›:objects:household
mouse trap = ğŸª¤:objects:household
razor = ğŸª’:objects:household
lotion bottle = ğŸ§´:objects:household
safety pin = ğŸ§·:objects:household
broom = ğŸ§¹:objects:household
basket = ğŸ§º:objects:household
roll of paper = ğŸ§»:objects:household
bucket = ğŸª£:objects:household
soap = ğŸ§¼:objects:household
bubbles = ğŸ«§:objects:household
toothbrush = ğŸª¥:objects:household
sponge = ğŸ§½:objects:household
fire extinguisher = ğŸ§¯:objects:household
shopping cart = ğŸ›’:objects:household
cigarette = ğŸš¬:objects:other_object
coffin = âš°:objects:other_object
headstone = ğŸª¦:objects:other_object
funeral urn = âš±:objects:other_object
moai = ğŸ—¿:objects:other_object
placard = ğŸª§:objects:other_object
identification card = ğŸªª:objects:other_object
ATM sign = ğŸ§:symbols:transport_sign
litter in bin sign = ğŸš®:symbols:transport_sign
potable water = ğŸš°:symbols:transport_sign
wheelchair symbol = â™¿:symbols:transport_sign
menâ€™s room = ğŸš¹:symbols:transport_sign
womenâ€™s room = ğŸšº:symbols:transport_sign
restroom = ğŸš»:symbols:transport_sign
baby symbol = ğŸš¼:symbols:transport_sign
water closet = ğŸš¾:symbols:transport_sign
passport control = ğŸ›‚:symbols:transport_sign
customs = ğŸ›ƒ:symbols:transport_sign
baggage claim = ğŸ›„:symbols:transport_sign
left luggage = ğŸ›…:symbols:transport_sign
warning = âš :symbols:warning
children crossing = ğŸš¸:symbols:warning
no entry = â›”:symbols:warning
prohibited = ğŸš«:symbols:warning
no bicycles = ğŸš³:symbols:warning
no smoking = ğŸš­:symbols:warning
no littering = ğŸš¯:symbols:warning
non-potable water = ğŸš±:symbols:warning
no pedestrians = ğŸš·:symbols:warning
no mobile phones = ğŸ“µ:symbols:warning
no one under eighteen = ğŸ”:symbols:warning
radioactive = â˜¢:symbols:warning
biohazard = â˜£:symbols:warning
up arrow = â¬†:symbols:arrow
up-right arrow = â†—:symbols:arrow
right arrow = â¡:symbols:arrow
down-right arrow = â†˜:symbols:arrow
down arrow = â¬‡:symbols:arrow
down-left arrow = â†™:symbols:arrow
left arrow = â¬…:symbols:arrow
up-left arrow = â†–:symbols:arrow
up-down arrow = â†•:symbols:arrow
left-right arrow = â†”:symbols:arrow
right arrow curving left = â†©:symbols:arrow
left arrow curving right = â†ª:symbols:arrow
right arrow curving up = â¤´:symbols:arrow
right arrow curving down = â¤µ:symbols:arrow
clockwise vertical arrows = ğŸ”ƒ:symbols:arrow
counterclockwise arrows button = ğŸ”„:symbols:arrow
BACK arrow = ğŸ”™:symbols:arrow
END arrow = ğŸ”š:symbols:arrow
ON! arrow = ğŸ”›:symbols:arrow
SOON arrow = ğŸ”œ:symbols:arrow
TOP arrow = ğŸ”:symbols:arrow
place of worship = ğŸ›:symbols:religion
atom symbol = âš›:symbols:religion
om = ğŸ•‰:symbols:religion
star of David = âœ¡:symbols:religion
wheel of dharma = â˜¸:symbols:religion
yin yang = â˜¯:symbols:religion
latin cross = âœ:symbols:religion
orthodox cross = â˜¦:symbols:religion
star and crescent = â˜ª:symbols:religion
peace symbol = â˜®:symbols:religion
menorah = ğŸ•:symbols:religion
dotted six-pointed star = ğŸ”¯:symbols:religion
Aries = â™ˆ:symbols:zodiac
Taurus = â™‰:symbols:zodiac
Gemini = â™Š:symbols:zodiac
Cancer = â™‹:symbols:zodiac
Leo = â™Œ:symbols:zodiac
Virgo = â™:symbols:zodiac
Libra = â™:symbols:zodiac
Scorpio = â™:symbols:zodiac
Sagittarius = â™:symbols:zodiac
Capricorn = â™‘:symbols:zodiac
Aquarius = â™’:symbols:zodiac
Pisces = â™“:symbols:zodiac
Ophiuchus = â›:symbols:zodiac
shuffle tracks button = ğŸ”€:symbols:av_symbol
repeat button = ğŸ”:symbols:av_symbol
repeat single button = ğŸ”‚:symbols:av_symbol
play button = â–¶:symbols:av_symbol
fast-forward button = â©:symbols:av_symbol
next track button = â­:symbols:av_symbol
play or pause button = â¯:symbols:av_symbol
reverse button = â—€:symbols:av_symbol
fast reverse button = âª:symbols:av_symbol
last track button = â®:symbols:av_symbol
upwards button = ğŸ”¼:symbols:av_symbol
fast up button = â«:symbols:av_symbol
downwards button = ğŸ”½:symbols:av_symbol
fast down button = â¬:symbols:av_symbol
pause button = â¸:symbols:av_symbol
stop button = â¹:symbols:av_symbol
record button = âº:symbols:av_symbol
eject button = â:symbols:av_symbol
cinema = ğŸ¦:symbols:av_symbol
dim button = ğŸ”…:symbols:av_symbol
bright button = ğŸ”†:symbols:av_symbol
antenna bars = ğŸ“¶:symbols:av_symbol
vibration mode = ğŸ“³:symbols:av_symbol
mobile phone off = ğŸ“´:symbols:av_symbol
female sign = â™€:symbols:gender
male sign = â™‚:symbols:gender
transgender symbol = âš§:symbols:gender
multiply = âœ–:symbols:math
plus = â•:symbols:math
minus = â–:symbols:math
divide = â—:symbols:math
heavy equals sign = ğŸŸ°:symbols:math
infinity = â™¾:symbols:math
double exclamation mark = â€¼:symbols:punctuation
exclamation question mark = â‰:symbols:punctuation
red question mark = â“:symbols:punctuation
white question mark = â”:symbols:punctuation
white exclamation mark = â•:symbols:punctuation
red exclamation mark = â—:symbols:punctuation
wavy dash = ã€°:symbols:punctuation
currency exchange = ğŸ’±:symbols:currency
heavy dollar sign = ğŸ’²:symbols:currency
medical symbol = âš•:symbols:other_symbol
recycling symbol = â™»:symbols:other_symbol
fleur-de-lis = âšœ:symbols:other_symbol
trident emblem = ğŸ”±:symbols:other_symbol
name badge = ğŸ“›:symbols:other_symbol
Japanese symbol for beginner = ğŸ”°:symbols:other_symbol
hollow red circle = â­•:symbols:other_symbol
check mark button = âœ…:symbols:other_symbol
check box with check = â˜‘:symbols:other_symbol
check mark = âœ”:symbols:other_symbol
cross mark = âŒ:symbols:other_symbol
cross mark button = â:symbols:other_symbol
curly loop = â°:symbols:other_symbol
double curly loop = â¿:symbols:other_symbol
part alternation mark = ã€½:symbols:other_symbol
eight-spoked asterisk = âœ³:symbols:other_symbol
eight-pointed star = âœ´:symbols:other_symbol
sparkle = â‡:symbols:other_symbol
copyright = Â©:symbols:other_symbol
registered = Â®:symbols:other_symbol
trade mark = â„¢:symbols:other_symbol
keycap # = âƒ£:symbols:keycap
keycap * = *âƒ£:symbols:keycap
keycap 0 = 0âƒ£:symbols:keycap
keycap 1 = 1âƒ£:symbols:keycap
keycap 2 = 2âƒ£:symbols:keycap
keycap 3 = 3âƒ£:symbols:keycap
keycap 4 = 4âƒ£:symbols:keycap
keycap 5 = 5âƒ£:symbols:keycap
keycap 6 = 6âƒ£:symbols:keycap
keycap 7 = 7âƒ£:symbols:keycap
keycap 8 = 8âƒ£:symbols:keycap
keycap 9 = 9âƒ£:symbols:keycap
keycap 10 = ğŸ”Ÿ:symbols:keycap
input latin uppercase = ğŸ” :symbols:alphanum
input latin lowercase = ğŸ”¡:symbols:alphanum
input numbers = ğŸ”¢:symbols:alphanum
input symbols = ğŸ”£:symbols:alphanum
input latin letters = ğŸ”¤:symbols:alphanum
A button (blood type) = ğŸ…°:symbols:alphanum
AB button (blood type) = ğŸ†:symbols:alphanum
B button (blood type) = ğŸ…±:symbols:alphanum
CL button = ğŸ†‘:symbols:alphanum
COOL button = ğŸ†’:symbols:alphanum
FREE button = ğŸ†“:symbols:alphanum
information = â„¹:symbols:alphanum
ID button = ğŸ†”:symbols:alphanum
circled M = â“‚:symbols:alphanum
NEW button = ğŸ†•:symbols:alphanum
NG button = ğŸ†–:symbols:alphanum
O button (blood type) = ğŸ…¾:symbols:alphanum
OK button = ğŸ†—:symbols:alphanum
P button = ğŸ…¿:symbols:alphanum
SOS button = ğŸ†˜:symbols:alphanum
UP! button = ğŸ†™:symbols:alphanum
VS button = ğŸ†š:symbols:alphanum
Japanese â€œhereâ€ button = ğŸˆ:symbols:alphanum
Japanese service charge button = ğŸˆ‚ï¸:symbols:alphanum
Japanese â€œservice chargeâ€ button = ğŸˆ‚:symbols:alphanum
Japanese monthly amount button = ğŸˆ·ï¸:symbols:alphanum
Japanese â€œmonthly amountâ€ button = ğŸˆ·:symbols:alphanum
Japanese â€œnot free of chargeâ€ button = ğŸˆ¶:symbols:alphanum
Japanese â€œreservedâ€ button = ğŸˆ¯:symbols:alphanum
Japanese â€œbargainâ€ button = ğŸ‰:symbols:alphanum
Japanese â€œdiscountâ€ button = ğŸˆ¹:symbols:alphanum
Japanese â€œfree of chargeâ€ button = ğŸˆš:symbols:alphanum
Japanese â€œprohibitedâ€ button = ğŸˆ²:symbols:alphanum
Japanese â€œacceptableâ€ button = ğŸ‰‘:symbols:alphanum
Japanese â€œapplicationâ€ button = ğŸˆ¸:symbols:alphanum
Japanese â€œpassing gradeâ€ button = ğŸˆ´:symbols:alphanum
Japanese â€œvacancyâ€ button = ğŸˆ³:symbols:alphanum
Japanese congratulations button = ãŠ—ï¸:symbols:alphanum
Japanese â€œcongratulationsâ€ button = ãŠ—:symbols:alphanum
Japanese secret button = ãŠ™ï¸:symbols:alphanum
Japanese â€œsecretâ€ button = ãŠ™:symbols:alphanum
Japanese â€œopen for businessâ€ button = ğŸˆº:symbols:alphanum
Japanese â€œno vacancyâ€ button = ğŸˆµ:symbols:alphanum
red circle = ğŸ”´:symbols:geometric
orange circle = ğŸŸ :symbols:geometric
yellow circle = ğŸŸ¡:symbols:geometric
green circle = ğŸŸ¢:symbols:geometric
blue circle = ğŸ”µ:symbols:geometric
purple circle = ğŸŸ£:symbols:geometric
brown circle = ğŸŸ¤:symbols:geometric
black circle = âš«:symbols:geometric
white circle = âšª:symbols:geometric
red square = ğŸŸ¥:symbols:geometric
orange square = ğŸŸ§:symbols:geometric
yellow square = ğŸŸ¨:symbols:geometric
green square = ğŸŸ©:symbols:geometric
blue square = ğŸŸ¦:symbols:geometric
purple square = ğŸŸª:symbols:geometric
brown square = ğŸŸ«:symbols:geometric
black large square = â¬›:symbols:geometric
white large square = â¬œ:symbols:geometric
black medium square = â—¼:symbols:geometric
white medium square = â—»:symbols:geometric
black medium-small square = â—¾:symbols:geometric
white medium-small square = â—½:symbols:geometric
black small square = â–ª:symbols:geometric
white small square = â–«:symbols:geometric
large orange diamond = ğŸ”¶:symbols:geometric
large blue diamond = ğŸ”·:symbols:geometric
small orange diamond = ğŸ”¸:symbols:geometric
small blue diamond = ğŸ”¹:symbols:geometric
red triangle pointed up = ğŸ”º:symbols:geometric
red triangle pointed down = ğŸ”»:symbols:geometric
diamond with a dot = ğŸ’ :symbols:geometric
radio button = ğŸ”˜:symbols:geometric
white square button = ğŸ”³:symbols:geometric
black square button = ğŸ”²:symbols:geometric
chequered flag = ğŸ:flags:flag
triangular flag = ğŸš©:flags:flag
crossed flags = ğŸŒ:flags:flag
black flag = ğŸ´:flags:flag
white flag = ğŸ³:flags:flag
rainbow flag = ğŸ³â€ğŸŒˆ:flags:flag
transgender flag = ğŸ³â€âš§:flags:flag
pirate flag = ğŸ´â€â˜ :flags:flag
Ascension Island = ğŸ‡¦ğŸ‡¨:flags:country_flag
Andorra = ğŸ‡¦ğŸ‡©:flags:country_flag
United Arab Emirates = ğŸ‡¦ğŸ‡ª:flags:country_flag
Afghanistan = ğŸ‡¦ğŸ‡«:flags:country_flag
Antigua & Barbuda = ğŸ‡¦ğŸ‡¬:flags:country_flag
Anguilla = ğŸ‡¦ğŸ‡®:flags:country_flag
Albania = ğŸ‡¦ğŸ‡±:flags:country_flag
Armenia = ğŸ‡¦ğŸ‡²:flags:country_flag
Angola = ğŸ‡¦ğŸ‡´:flags:country_flag
Antarctica = ğŸ‡¦ğŸ‡¶:flags:country_flag
Argentina = ğŸ‡¦ğŸ‡·:flags:country_flag
American Samoa = ğŸ‡¦ğŸ‡¸:flags:country_flag
Austria = ğŸ‡¦ğŸ‡¹:flags:country_flag
Australia = ğŸ‡¦ğŸ‡º:flags:country_flag
Aruba = ğŸ‡¦ğŸ‡¼:flags:country_flag
Ã…land Islands = ğŸ‡¦ğŸ‡½:flags:country_flag
Azerbaijan = ğŸ‡¦ğŸ‡¿:flags:country_flag
Bosnia & Herzegovina = ğŸ‡§ğŸ‡¦:flags:country_flag
Barbados = ğŸ‡§ğŸ‡§:flags:country_flag
Bangladesh = ğŸ‡§ğŸ‡©:flags:country_flag
Belgium = ğŸ‡§ğŸ‡ª:flags:country_flag
Burkina Faso = ğŸ‡§ğŸ‡«:flags:country_flag
Bulgaria = ğŸ‡§ğŸ‡¬:flags:country_flag
Bahrain = ğŸ‡§ğŸ‡­:flags:country_flag
Burundi = ğŸ‡§ğŸ‡®:flags:country_flag
Benin = ğŸ‡§ğŸ‡¯:flags:country_flag
St. BarthÃ©lemy = ğŸ‡§ğŸ‡±:flags:country_flag
Bermuda = ğŸ‡§ğŸ‡²:flags:country_flag
Brunei = ğŸ‡§ğŸ‡³:flags:country_flag
Bolivia = ğŸ‡§ğŸ‡´:flags:country_flag
Caribbean Netherlands = ğŸ‡§ğŸ‡¶:flags:country_flag
Brazil = ğŸ‡§ğŸ‡·:flags:country_flag
Bahamas = ğŸ‡§ğŸ‡¸:flags:country_flag
Bhutan = ğŸ‡§ğŸ‡¹:flags:country_flag
Bouvet Island = ğŸ‡§ğŸ‡»:flags:country_flag
Botswana = ğŸ‡§ğŸ‡¼:flags:country_flag
Belarus = ğŸ‡§ğŸ‡¾:flags:country_flag
Belize = ğŸ‡§ğŸ‡¿:flags:country_flag
Canada = ğŸ‡¨ğŸ‡¦:flags:country_flag
Cocos (Keeling) Islands = ğŸ‡¨ğŸ‡¨:flags:country_flag
Congo - Kinshasa = ğŸ‡¨ğŸ‡©:flags:country_flag
Central African Republic = ğŸ‡¨ğŸ‡«:flags:country_flag
Congo - Brazzaville = ğŸ‡¨ğŸ‡¬:flags:country_flag
Switzerland = ğŸ‡¨ğŸ‡­:flags:country_flag
CÃ´te dâ€™Ivoire = ğŸ‡¨ğŸ‡®:flags:country_flag
Cook Islands = ğŸ‡¨ğŸ‡°:flags:country_flag
Chile = ğŸ‡¨ğŸ‡±:flags:country_flag
Cameroon = ğŸ‡¨ğŸ‡²:flags:country_flag
China = ğŸ‡¨ğŸ‡³:flags:country_flag
Colombia = ğŸ‡¨ğŸ‡´:flags:country_flag
Clipperton Island = ğŸ‡¨ğŸ‡µ:flags:country_flag
Costa Rica = ğŸ‡¨ğŸ‡·:flags:country_flag
Cuba = ğŸ‡¨ğŸ‡º:flags:country_flag
Cape Verde = ğŸ‡¨ğŸ‡»:flags:country_flag
CuraÃ§ao = ğŸ‡¨ğŸ‡¼:flags:country_flag
Christmas Island = ğŸ‡¨ğŸ‡½:flags:country_flag
Cyprus = ğŸ‡¨ğŸ‡¾:flags:country_flag
Czechia = ğŸ‡¨ğŸ‡¿:flags:country_flag
Germany = ğŸ‡©ğŸ‡ª:flags:country_flag
Diego Garcia = ğŸ‡©ğŸ‡¬:flags:country_flag
Djibouti = ğŸ‡©ğŸ‡¯:flags:country_flag
Denmark = ğŸ‡©ğŸ‡°:flags:country_flag
Dominica = ğŸ‡©ğŸ‡²:flags:country_flag
Dominican Republic = ğŸ‡©ğŸ‡´:flags:country_flag
Algeria = ğŸ‡©ğŸ‡¿:flags:country_flag
Ceuta & Melilla = ğŸ‡ªğŸ‡¦:flags:country_flag
Ecuador = ğŸ‡ªğŸ‡¨:flags:country_flag
Estonia = ğŸ‡ªğŸ‡ª:flags:country_flag
Egypt = ğŸ‡ªğŸ‡¬:flags:country_flag
Western Sahara = ğŸ‡ªğŸ‡­:flags:country_flag
Eritrea = ğŸ‡ªğŸ‡·:flags:country_flag
Spain = ğŸ‡ªğŸ‡¸:flags:country_flag
Ethiopia = ğŸ‡ªğŸ‡¹:flags:country_flag
European Union = ğŸ‡ªğŸ‡º:flags:country_flag
Finland = ğŸ‡«ğŸ‡®:flags:country_flag
Fiji = ğŸ‡«ğŸ‡¯:flags:country_flag
Falkland Islands = ğŸ‡«ğŸ‡°:flags:country_flag
Micronesia = ğŸ‡«ğŸ‡²:flags:country_flag
Faroe Islands = ğŸ‡«ğŸ‡´:flags:country_flag
France = ğŸ‡«ğŸ‡·:flags:country_flag
Gabon = ğŸ‡¬ğŸ‡¦:flags:country_flag
United Kingdom = ğŸ‡¬ğŸ‡§:flags:country_flag
Grenada = ğŸ‡¬ğŸ‡©:flags:country_flag
Georgia = ğŸ‡¬ğŸ‡ª:flags:country_flag
French Guiana = ğŸ‡¬ğŸ‡«:flags:country_flag
Guernsey = ğŸ‡¬ğŸ‡¬:flags:country_flag
Ghana = ğŸ‡¬ğŸ‡­:flags:country_flag
Gibraltar = ğŸ‡¬ğŸ‡®:flags:country_flag
Greenland = ğŸ‡¬ğŸ‡±:flags:country_flag
Gambia = ğŸ‡¬ğŸ‡²:flags:country_flag
Guinea = ğŸ‡¬ğŸ‡³:flags:country_flag
Guadeloupe = ğŸ‡¬ğŸ‡µ:flags:country_flag
Equatorial Guinea = ğŸ‡¬ğŸ‡¶:flags:country_flag
Greece = ğŸ‡¬ğŸ‡·:flags:country_flag
South Georgia & South Sandwich Islands = ğŸ‡¬ğŸ‡¸:flags:country_flag
Guatemala = ğŸ‡¬ğŸ‡¹:flags:country_flag
Guam = ğŸ‡¬ğŸ‡º:flags:country_flag
Guinea-Bissau = ğŸ‡¬ğŸ‡¼:flags:country_flag
Guyana = ğŸ‡¬ğŸ‡¾:flags:country_flag
Hong Kong SAR China = ğŸ‡­ğŸ‡°:flags:country_flag
Heard & McDonald Islands = ğŸ‡­ğŸ‡²:flags:country_flag
Honduras = ğŸ‡­ğŸ‡³:flags:country_flag
Croatia = ğŸ‡­ğŸ‡·:flags:country_flag
Haiti = ğŸ‡­ğŸ‡¹:flags:country_flag
Hungary = ğŸ‡­ğŸ‡º:flags:country_flag
Canary Islands = ğŸ‡®ğŸ‡¨:flags:country_flag
Indonesia = ğŸ‡®ğŸ‡©:flags:country_flag
Ireland = ğŸ‡®ğŸ‡ª:flags:country_flag
Israel = ğŸ‡®ğŸ‡±:flags:country_flag
Isle of Man = ğŸ‡®ğŸ‡²:flags:country_flag
India = ğŸ‡®ğŸ‡³:flags:country_flag
British Indian Ocean Territory = ğŸ‡®ğŸ‡´:flags:country_flag
Iraq = ğŸ‡®ğŸ‡¶:flags:country_flag
Iran = ğŸ‡®ğŸ‡·:flags:country_flag
Iceland = ğŸ‡®ğŸ‡¸:flags:country_flag
Italy = ğŸ‡®ğŸ‡¹:flags:country_flag
Jersey = ğŸ‡¯ğŸ‡ª:flags:country_flag
Jamaica = ğŸ‡¯ğŸ‡²:flags:country_flag
Jordan = ğŸ‡¯ğŸ‡´:flags:country_flag
Japan = ğŸ‡¯ğŸ‡µ:flags:country_flag
Kenya = ğŸ‡°ğŸ‡ª:flags:country_flag
Kyrgyzstan = ğŸ‡°ğŸ‡¬:flags:country_flag
Cambodia = ğŸ‡°ğŸ‡­:flags:country_flag
Kiribati = ğŸ‡°ğŸ‡®:flags:country_flag
Comoros = ğŸ‡°ğŸ‡²:flags:country_flag
St. Kitts & Nevis = ğŸ‡°ğŸ‡³:flags:country_flag
North Korea = ğŸ‡°ğŸ‡µ:flags:country_flag
South Korea = ğŸ‡°ğŸ‡·:flags:country_flag
Kuwait = ğŸ‡°ğŸ‡¼:flags:country_flag
Cayman Islands = ğŸ‡°ğŸ‡¾:flags:country_flag
Kazakhstan = ğŸ‡°ğŸ‡¿:flags:country_flag
Laos = ğŸ‡±ğŸ‡¦:flags:country_flag
Lebanon = ğŸ‡±ğŸ‡§:flags:country_flag
St. Lucia = ğŸ‡±ğŸ‡¨:flags:country_flag
Liechtenstein = ğŸ‡±ğŸ‡®:flags:country_flag
Sri Lanka = ğŸ‡±ğŸ‡°:flags:country_flag
Liberia = ğŸ‡±ğŸ‡·:flags:country_flag
Lesotho = ğŸ‡±ğŸ‡¸:flags:country_flag
Lithuania = ğŸ‡±ğŸ‡¹:flags:country_flag
Luxembourg = ğŸ‡±ğŸ‡º:flags:country_flag
Latvia = ğŸ‡±ğŸ‡»:flags:country_flag
Libya = ğŸ‡±ğŸ‡¾:flags:country_flag
Morocco = ğŸ‡²ğŸ‡¦:flags:country_flag
Monaco = ğŸ‡²ğŸ‡¨:flags:country_flag
Moldova = ğŸ‡²ğŸ‡©:flags:country_flag
Montenegro = ğŸ‡²ğŸ‡ª:flags:country_flag
St. Martin = ğŸ‡²ğŸ‡«:flags:country_flag
Madagascar = ğŸ‡²ğŸ‡¬:flags:country_flag
Marshall Islands = ğŸ‡²ğŸ‡­:flags:country_flag
North Macedonia = ğŸ‡²ğŸ‡°:flags:country_flag
Mali = ğŸ‡²ğŸ‡±:flags:country_flag
Myanmar (Burma) = ğŸ‡²ğŸ‡²:flags:country_flag
Mongolia = ğŸ‡²ğŸ‡³:flags:country_flag
Macao SAR China = ğŸ‡²ğŸ‡´:flags:country_flag
Northern Mariana Islands = ğŸ‡²ğŸ‡µ:flags:country_flag
Martinique = ğŸ‡²ğŸ‡¶:flags:country_flag
Mauritania = ğŸ‡²ğŸ‡·:flags:country_flag
Montserrat = ğŸ‡²ğŸ‡¸:flags:country_flag
Malta = ğŸ‡²ğŸ‡¹:flags:country_flag
Mauritius = ğŸ‡²ğŸ‡º:flags:country_flag
Maldives = ğŸ‡²ğŸ‡»:flags:country_flag
Malawi = ğŸ‡²ğŸ‡¼:flags:country_flag
Mexico = ğŸ‡²ğŸ‡½:flags:country_flag
Malaysia = ğŸ‡²ğŸ‡¾:flags:country_flag
Mozambique = ğŸ‡²ğŸ‡¿:flags:country_flag
Namibia = ğŸ‡³ğŸ‡¦:flags:country_flag
New Caledonia = ğŸ‡³ğŸ‡¨:flags:country_flag
Niger = ğŸ‡³ğŸ‡ª:flags:country_flag
Norfolk Island = ğŸ‡³ğŸ‡«:flags:country_flag
Nigeria = ğŸ‡³ğŸ‡¬:flags:country_flag
Nicaragua = ğŸ‡³ğŸ‡®:flags:country_flag
Netherlands = ğŸ‡³ğŸ‡±:flags:country_flag
Norway = ğŸ‡³ğŸ‡´:flags:country_flag
Nepal = ğŸ‡³ğŸ‡µ:flags:country_flag
Nauru = ğŸ‡³ğŸ‡·:flags:country_flag
Niue = ğŸ‡³ğŸ‡º:flags:country_flag
New Zealand = ğŸ‡³ğŸ‡¿:flags:country_flag
Oman = ğŸ‡´ğŸ‡²:flags:country_flag
Panama = ğŸ‡µğŸ‡¦:flags:country_flag
Peru = ğŸ‡µğŸ‡ª:flags:country_flag
French Polynesia = ğŸ‡µğŸ‡«:flags:country_flag
Papua New Guinea = ğŸ‡µğŸ‡¬:flags:country_flag
Philippines = ğŸ‡µğŸ‡­:flags:country_flag
Pakistan = ğŸ‡µğŸ‡°:flags:country_flag
Poland = ğŸ‡µğŸ‡±:flags:country_flag
St. Pierre & Miquelon = ğŸ‡µğŸ‡²:flags:country_flag
Pitcairn Islands = ğŸ‡µğŸ‡³:flags:country_flag
Puerto Rico = ğŸ‡µğŸ‡·:flags:country_flag
Palestinian Territories = ğŸ‡µğŸ‡¸:flags:country_flag
Portugal = ğŸ‡µğŸ‡¹:flags:country_flag
Palau = ğŸ‡µğŸ‡¼:flags:country_flag
Paraguay = ğŸ‡µğŸ‡¾:flags:country_flag
Qatar = ğŸ‡¶ğŸ‡¦:flags:country_flag
RÃ©union = ğŸ‡·ğŸ‡ª:flags:country_flag
Romania = ğŸ‡·ğŸ‡´:flags:country_flag
Serbia = ğŸ‡·ğŸ‡¸:flags:country_flag
Russia = ğŸ‡·ğŸ‡º:flags:country_flag
Rwanda = ğŸ‡·ğŸ‡¼:flags:country_flag
Saudi Arabia = ğŸ‡¸ğŸ‡¦:flags:country_flag
Solomon Islands = ğŸ‡¸ğŸ‡§:flags:country_flag
Seychelles = ğŸ‡¸ğŸ‡¨:flags:country_flag
Sudan = ğŸ‡¸ğŸ‡©:flags:country_flag
Sweden = ğŸ‡¸ğŸ‡ª:flags:country_flag
Singapore = ğŸ‡¸ğŸ‡¬:flags:country_flag
St. Helena = ğŸ‡¸ğŸ‡­:flags:country_flag
Slovenia = ğŸ‡¸ğŸ‡®:flags:country_flag
Svalbard & Jan Mayen = ğŸ‡¸ğŸ‡¯:flags:country_flag
Slovakia = ğŸ‡¸ğŸ‡°:flags:country_flag
Sierra Leone = ğŸ‡¸ğŸ‡±:flags:country_flag
San Marino = ğŸ‡¸ğŸ‡²:flags:country_flag
Senegal = ğŸ‡¸ğŸ‡³:flags:country_flag
Somalia = ğŸ‡¸ğŸ‡´:flags:country_flag
Suriname = ğŸ‡¸ğŸ‡·:flags:country_flag
South Sudan = ğŸ‡¸ğŸ‡¸:flags:country_flag
SÃ£o TomÃ© & PrÃ­ncipe = ğŸ‡¸ğŸ‡¹:flags:country_flag
El Salvador = ğŸ‡¸ğŸ‡»:flags:country_flag
Sint Maarten = ğŸ‡¸ğŸ‡½:flags:country_flag
Syria = ğŸ‡¸ğŸ‡¾:flags:country_flag
Eswatini = ğŸ‡¸ğŸ‡¿:flags:country_flag
Tristan da Cunha = ğŸ‡¹ğŸ‡¦:flags:country_flag
Turks & Caicos Islands = ğŸ‡¹ğŸ‡¨:flags:country_flag
Chad = ğŸ‡¹ğŸ‡©:flags:country_flag
French Southern Territories = ğŸ‡¹ğŸ‡«:flags:country_flag
Togo = ğŸ‡¹ğŸ‡¬:flags:country_flag
Thailand = ğŸ‡¹ğŸ‡­:flags:country_flag
Tajikistan = ğŸ‡¹ğŸ‡¯:flags:country_flag
Tokelau = ğŸ‡¹ğŸ‡°:flags:country_flag
Timor-Leste = ğŸ‡¹ğŸ‡±:flags:country_flag
Turkmenistan = ğŸ‡¹ğŸ‡²:flags:country_flag
Tunisia = ğŸ‡¹ğŸ‡³:flags:country_flag
Tonga = ğŸ‡¹ğŸ‡´:flags:country_flag
Turkey = ğŸ‡¹ğŸ‡·:flags:country_flag
Trinidad & Tobago = ğŸ‡¹ğŸ‡¹:flags:country_flag
Tuvalu = ğŸ‡¹ğŸ‡»:flags:country_flag
Taiwan = ğŸ‡¹ğŸ‡¼:flags:country_flag
Tanzania = ğŸ‡¹ğŸ‡¿:flags:country_flag
Ukraine = ğŸ‡ºğŸ‡¦:flags:country_flag
Uganda = ğŸ‡ºğŸ‡¬:flags:country_flag
U.S. Outlying Islands = ğŸ‡ºğŸ‡²:flags:country_flag
United Nations = ğŸ‡ºğŸ‡³:flags:country_flag
United States = ğŸ‡ºğŸ‡¸:flags:country_flag
Uruguay = ğŸ‡ºğŸ‡¾:flags:country_flag
Uzbekistan = ğŸ‡ºğŸ‡¿:flags:country_flag
Vatican City = ğŸ‡»ğŸ‡¦:flags:country_flag
St. Vincent & Grenadines = ğŸ‡»ğŸ‡¨:flags:country_flag
Venezuela = ğŸ‡»ğŸ‡ª:flags:country_flag
British Virgin Islands = ğŸ‡»ğŸ‡¬:flags:country_flag
U.S. Virgin Islands = ğŸ‡»ğŸ‡®:flags:country_flag
Vietnam = ğŸ‡»ğŸ‡³:flags:country_flag
Vanuatu = ğŸ‡»ğŸ‡º:flags:country_flag
Wallis & Futuna = ğŸ‡¼ğŸ‡«:flags:country_flag
Samoa = ğŸ‡¼ğŸ‡¸:flags:country_flag
Kosovo = ğŸ‡½ğŸ‡°:flags:country_flag
Yemen = ğŸ‡¾ğŸ‡ª:flags:country_flag
Mayotte = ğŸ‡¾ğŸ‡¹:flags:country_flag
South Africa = ğŸ‡¿ğŸ‡¦:flags:country_flag
Zambia = ğŸ‡¿ğŸ‡²:flags:country_flag
Zimbabwe = ğŸ‡¿ğŸ‡¼:flags:country_flag
England = ğŸ´ó §ó ¢ó ¥ó ®ó §ó ¿:flags:subdivision_flag
Scotland = ğŸ´ó §ó ¢ó ³ó £ó ´ó ¿:flags:subdivision_flag
Wales = ğŸ´ó §ó ¢ó ·ó ¬ó ³ó ¿:flags:subdivision_flag
